Telephone Calls by Prime Minister on New Year	ಹೊಸ ವರ್ಷದಂದು ಪ್ರಧಾನಮಂತ್ರಿಯವರಿಂದ ದೂರವಾಣಿ ಕರೆಗಳು
On the occasion of the New Year, Prime MinisterShri Narendra Moditoday had telephone conversation with HJigme Khesar Namgyel Wangchuck, The Druk Gyalpo of Kingdom of Bhutan and Lyonchhen (DrLotay Tshering, Prime Minister of Bhutan, Mrtabaya Rajapaksa, President and Mrhinda Rajapaksa, Prime Minister of Sri Lanka, Mrrahim Mohamed Solih, President of the Maldives, Mseikh Hasina, Prime Minister of Bangladesh and MrParma Oli, Prime Minister of Nepal.	ಭೂತಾನ್ ದೊರೆ ಶ್ರೀ ಜಿಗ್ಮೆ ಖೇಸರ್ ನಂಗೆಲ್ ವಾಂಗ್ಚುಕ್ ಮತ್ತು ಪ್ರಧಾನ ಮಂತ್ರಿ ಶ್ರೀ ಲಿಯೊನ್ಚೆನ್ (ಡಾ) ಲೋಟೇ ಶೇರಿಂಗ್, ಶ್ರೀಲಂಕಾ ಅಧ್ಯಕ್ಷ ಗೋಟಬಯಾ ರಾಜಪಕ್ಸೆ ಮತ್ತು ಪ್ರಧಾನಿ ಶ್ರೀ ಮಹಿಂದಾ ರಾಜಪಕ್ಸೆ, ಮಾಲ್ಡೀವ್ಸ್ ಅಧ್ಯಕ್ಷ ಶ್ರೀ ಇಬ್ರಾಹಿಂ ಮೊಹಮ್ಮದ್ ಸೊಲಿಹ್, ಬಾಂಗ್ಲಾದೇಶದ ಪ್ರಧಾನಿ ಶ್ರೀಮತಿ ಶೇಖ್ ಹಸೀನಾ ಮತ್ತು ನೇಪಾಳ ಪ್ರಧಾನಿ ಶ್ರೀ ಕೆ ಿ ರ್ಮಾ ಒಲಿ ಅವರೊಂದಿಗೆ ದೂರವಾಣಿ ಸಂಭಾಷಣೆ ನಡೆಸಿದರು.
He emphasized Indias commitment to Neighbourhood First policy and the vision of shared peace, security, prosperity and progress for all of Indias friends and partners in the region.	‘ನೆರೆಹೊರೆಯವರು ಮೊದಲು’ ನೀತಿಗೆ ಭಾರತದ ಬದ್ಧತೆ ಮತ್ತು ಪರಸ್ಪರ ಶಾಂತಿ, ಸುರಕ್ಷತೆ, ಸಮೃದ್ಧಿ ಮತ್ತು ಪ್ರಗತಿಯ ದೃಷ್ಟಿಕೋನವನ್ನು ಭಾರತದ ಎಲ್ಲ ಸ್ನೇಹಿತರು ಮತ್ತು ಈ ಪ್ರದೇಶದ ಪಾಲುದಾರರಿಗೆ ಅವರು ಒತ್ತಿ ಹೇಳಿದರು.
President of Sri Lanka Mrtabaya Rajapaksa warmly reciprocated the wishes of Prime Minister and expressed confidence that India and Sri Lanka would further enhance their friendly ties in the year 2020	ಶ್ರೀಲಂಕಾ ಅಧ್ಯಕ್ಷ ಶ್ರೀ ೋಟಬಯಾ ರಾಜಪಕ್ಸೆ ಅವರು ಪ್ರಧಾನಮಂತ್ರಿಯವರ ಶುಭಾಶಯಗಳನ್ನು ಪ್ರೀತಿಯಿಂದ ಸ್ವೀಕರಿಸಿದರು ಮತ್ತು 2020 ರಲ್ಲಿ ಭಾರತ ಮತ್ತು ಶ್ರೀಲಂಕಾ ತಮ್ಮ ಸ್ನೇಹ ಸಂಬಂಧವನ್ನು ಇನ್ನಷ್ಟು ವೃದ್ಧಿಸಿಕೊಳ್ಳುತ್ತವೆ ಎಂಬ ವಿಶ್ವಾಸವನ್ನು ವ್ಯಕ್ತಪಡಿಸಿದರು  ನಿಟ್ಟಿನಲ್ಲಿ ಒಟ್ಟಾಗಿ ಕೆಲಸ ಮಾಡುವ ಬದ್ಧತೆಯನ್ನು ಉಭಯ ನಾಯಕರು ಪುನರುಚ್ಚರಿಸಿದರು ್ರೀಲಂಕಾ ಪ್ರಧಾನ ಮಂತ್ರಿ ಮಹಿಂದಾ ರಾಜಪಕ್ಸೆ ಅವರೊಂದಿಗೆ ಮಾತನಾಡಿದ ಪ್ರಧಾನಿಯವರು, ಶ್ರೀಲಂಕಾದೊಂದಿಗೆ ನಿಕಟ ಮತ್ತು ವ್ಯಾಪಕವಾದ ಸಹಕಾರವನ್ನು ಇನ್ನಷ್ಟು ವಿಸ್ತರಿಸುವ ಭಾರತದ ಬದ್ಧತೆಯನ್ನು ಪುನರುಚ್ಚರಿಸಿದರು ್ರಧಾನಿ ರಾಜಪಕ್ಸೆಯವರು ಶುಭಾಶಯಗಳನ್ನು ತಿಳಿಸಿದರು ಮತ್ತು ಉಭಯ ದೇಶಗಳ ನಡುವಿನ ಸಂಬಂಧವನ್ನು ಇನ್ನಷ್ಟು ಹೆಚ್ಚಿಸುವ ಆಶಯ ವ್ಯಕ್ತಪಡಿಸಿದರು ಾಲ್ಡೀವ್ಸ್ ಅಧ್ಯಕ್ಷರು ಮತ್ತು ಮಾಲ್ಡೀವ್ಸ್ ಜನರು ಅಭಿವೃದ್ಧಿಯ ಎಲ್ಲಾ ಪ್ರಯತ್ನಗಳಲ್ಲಿ ಯಶಸ್ವಿಯಾಗಲಿ ಪ್ರಧಾನಿ ಶ್ರೀ ಮೋದಿ ಶುಭ ಹಾರೈಸಿದರು.
President Solih warmly reciprocated Prime Ministers wishes and expressed his keen desire to further deepen and strengthen the ties with India by enhancing the existing bilateral cooperation and exploring newer areas for working together.	ಅಧ್ಯಕ್ಷ ಸೋಲಿಹ್ ಅವರು ಪ್ರಧಾನಮಂತ್ರಿಯವರ ಆಶಯಗಳನ್ನು ಪ್ರೀತಿಯಿಂದ ಒಪ್ಪಿಕೊಂಡರು ಮತ್ತು ಅಸ್ತಿತ್ವದಲ್ಲಿರುವ ದ್ವಿಪಕ್ಷೀಯ ಸಹಕಾರವನ್ನು ಹೆಚ್ಚಿಸುವ ಮೂಲಕ ಮತ್ತು ಒಟ್ಟಾಗಿ ಕೆಲಸ ಮಾಡಲು ಹೊಸ ಕ್ಷೇತ್ರಗಳನ್ನು ಅನ್ವೇಷಿಸುವ ಮೂಲಕ ಭಾರತದೊಂದಿಗಿನ ಸಂಬಂಧಗಳನ್ನು ಇನ್ನಷ್ಟು ಗಾಢವಾಗಿಸಲು ಮತ್ತು ಬಲಪಡಿಸುವ  ಬಯಕೆಯನ್ನು ವ್ಯಕ್ತಪಡಿಸಿದರು ಾಂಗ್ಲಾದೇಶದ ಪ್ರಧಾನಿ ಶೇಖ್ ಹಸೀನಾ ಅವರೊಂದಿಗೆ ಮಾತನಾಡಿದ ಪ್ರಧಾನ ಮಂತ್ರಿಯವರು, ಮುಂದಿನ ಮೂರು ವರ್ಷಗಳ ಕಾಲ ಅವಾಮಿ ಲೀಗ್‌ನ ಅಧ್ಯಕ್ಷರಾಗಿ ಮರು ಆಯ್ಕೆಯಾಗಿರುವುದಕ್ಕಾಗಿ ಅವರನ್ನು ಅಭಿನಂದಿಸಿದರು.
Prime Minister also expressed his condolence on the untimely demise of former High Commissioner of Bangladesh to India Syed Muazzem Ali	ಭಾರತಕ್ಕೆ ಬಾಂಗ್ಲಾದೇಶದ ಮಾಜಿ ಹೈಕಮಿಷನರ್ ಸೈಯದ್ ಮುಜೀಂ ಅಲಿ ಅವರ ಅಕಾಲಿಕ ನಿಧನದ ಬಗ್ಗೆ ಪ್ರಧಾನಿ ಸಂತಾಪ ಸೂಚಿಸಿದರು 019 ರಲ್ಲಿ ಭಾರತ-ಬಾಂಗ್ಲಾದೇಶ ಸಂಬಂಧದಲ್ಲಿ ಸಾಧಿಸಿದ ಪ್ರಗತಿಯ ಬಗ್ಗೆ ಪ್ರಧಾನಿ ಗಮನ ಸೆಳೆದರು.
He also stated that the upcoming birth-centenary of Bangbandhu and 50 years of the Liberation of Bangladesh and establishment of bilateral diplomatic ties provided important milestones to further progress of the close India-Bangladesh ties, which is a priority of his Government.	ಮುಂಬರುವ ಬಂಗಬಂಧು ಜನ್ಮ ಶತಮಾನೋತ್ಸವ ಮತ್ತು ಬಾಂಗ್ಲಾದೇಶದ ವಿಮೋಚನೆಯ 50 ವರ್ಷಗಳು ಹಾಗೂ ದ್ವಿಪಕ್ಷೀಯ ರಾಜತಾಂತ್ರಿಕ ಸಂಬಂಧಗಳ ಸ್ಥಾಪನೆಯು, ತಮ್ಮ ಸರ್ಕಾರದ ಆದ್ಯತೆಯಾಗಿರುವ ಭಾರತ-ಬಾಂಗ್ಲಾದೇಶ ಸಂಬಂಧಗಳು ನಿಕಟವಾಗಲು ಹಾಗೂ ಮತ್ತಷ್ಟು ಪ್ರಗತಿಗೆ ಪ್ರಮುಖ ಮೈಲಿಗಲ್ಲುಗಳನ್ನು ಒದಗಿಸಲಿದೆದೆ ಎಂದು ಅವರು ಹೇಳಿದ್ದಾರೆ.
In his conversation with Prime Minister Oli, the Prime Minister expressed his satisfaction at the progress of India-Nepal relations in 2019, with the completion of several projects	ನೇಪಾಳ ಪ್ರಧಾನಿ ಒಲಿ ಅವರೊಂದಿಗಿನ ಸಂವಾದದಲ್ಲಿ, ಹಲವಾರು ಯೋಜನೆಗಳು ಪೂರ್ಣಗೊಂಡ 2019 ರಲ್ಲಿ ಭಾರತ-ನೇಪಾಳ ಸಂಬಂಧದ ಪ್ರಗತಿಯ ಬಗ್ಗೆ ಪ್ರಧಾನಿಯವರು ತಮ್ಮ ತೃಪ್ತಿಯನ್ನು ವ್ಯಕ್ತಪಡಿಸಿದರು.
He specifically noted the completion of Motihari (India)- Amlekhgunj (Nepal) petroleum products pipeline in a record time	ಮೋತಿಹಾರಿ (ಭಾರತ) - ಅಮ್ಲೆಖ್‌ಗುಂಜ್ (ನೇಪಾಳ) ಪೆಟ್ರೋಲಿಯಂ ಉತ್ಪನ್ನಗಳ ಪೈಪ್‌ಲೈನ್ ಅನ್ನು ದಾಖಲೆ ಸಮಯದಲ್ಲಿ ಪೂರ್ಣಗೊಳಿಸಿರುವುದನ್ನು ಅವರು ನಿರ್ದಿಷ್ಟವಾಗಿ ಪ್ರಸ್ತಾಪಿಸಿದರು.
Both the leaders also agreed for an early inauguration of the Integrated Check Post in Biratnagar and the housing reconstruction project in Nepal through video conference.	ಬಿರಾಟ್‌ನಗರದಲ್ಲಿ ಇಂಟಿಗ್ರೇಟೆಡ್ ಚೆಕ್ ಪೋಸ್ಟ್ ಮತ್ತು ನೇಪಾಳದ ವಸತಿ ಪುನರ್ನಿರ್ಮಾಣ ಯೋಜನೆಗಳನ್ನು ವೀಡಿಯೊ ಕಾನ್ಫರೆನ್ಸ್ ಮೂಲಕ ಶೀಘ್ರ ಉದ್ಘಾಟಿಸಲು ಇಬ್ಬರೂ ನಾಯಕರು ಸಮ್ಮತಿಸಿದರು.
PM to visit Karnataka on 2nd and 3rd January 2020	2020ರ ಜನವರಿ 2 ಮತ್ತು 3ರಂದು ಕರ್ನಾಟಕಕ್ಕೆ ಪ್ರಧಾನಮಂತ್ರಿ ಭೇಟಿ
PM to lay Foundation Stone for Memorial Museum of Shri Shri Shivakumar Swamiji	ಶ್ರೀ ಶ್ರೀ ಶಿವಕುಮಾರ ಸ್ವಾಮೀಜಿ ಸ್ಮಾರಕ ವಸ್ತುಸಂಗ್ರಹಾಲಯಕ್ಕೆ ಶಂಕುಸ್ಥಾಪನೆ ನೆರವೇರಿಸಲಿರುವ ಪ್ರಧಾನಮಂತ್ರಿ
The Prime Minister, Shri Narendra Modi, will visit Karnataka on 2ndand 3rdJanuary 2020	ಪ್ರಧಾನಮಂತ್ರಿ ಶ್ರೀ ನರೇಂದ್ರ ಮೋದಿ ಅವರು 2020 ಜನವರಿ 2 ಮತ್ತು 3ರಂದು ಕರ್ನಾಟಕಕ್ಕೆ ಭೇಟಿ ನೀಡಲಿದ್ದಾರೆ.
At Tumkur, He will visit the Sree Siddaganga Mutt, where he will unveil a plaque to mark the laying of Foundation Stone for a memorial museum of Shri Shri Shivakumar Swamiji.	ತುಮಕೂರಿನಲ್ಲಿ ಅವರು ಶ್ರೀ ಸಿದ್ದಗಂಗಾಮಠಕ್ಕೆ ಭೇಟಿ ನೀಡಿ, ಅಲ್ಲಿ ಶ್ರೀ ಶ್ರೀ ಶಿವಕುಮಾರ ಸ್ವಾಮೀಜಿ ಸ್ಮಾರಕ ವಸ್ತುಸಂಗ್ರಹಾಲಯಕ್ಕೆ ಶಂಕುಸ್ಥಾಪನೆ ನೆರವೇರಿಸುವ ಸಲುವಾಗಿ ಫಲಕ ಅನಾವರಣ ಮಾಡಲಿದ್ದಾರೆ
The Chief Minister of Karnataka Shri BYediyurappaand other dignitaries including Sh	ಕರ್ನಾಟಕ ಮುಖ್ಯಮಂತ್ರಿ ಶ್ರೀ ಬಿ ಸ್ ಡಿಯೂರಪ್ಪ ಮತ್ತು ಶ್ರೀ ಸಿದ್ದಲಿಂಗೇಶ್ವರ ಸ್ವಾಮಿ ಸೇರಿದಂತೆ ಇತರ ಗಣ್ಯರು  ಸಮಾರಂಭದಲ್ಲಿ ಉಪಸ್ಥಿತರಿರುತ್ತಾರೆ.
Prime Minister will address the gathering.	ಪ್ರಧಾನಮಂತ್ರಿಯವರು ಸಭಿಕರನ್ನುದ್ದೇಶಿಸಿ ಭಾಷಣ ಮಾಡಲಿದ್ದಾರೆ.
The Prime Minister Shri Narendra Modi will distribute Krishi Karman Awards and Commendation Awards to states at a public meeting in Tumkur Karnataka on Thursday, 22020	ಪ್ರಧಾನಮಂತ್ರಿ ಶ್ರೀ ನರೇಂದ್ರ ಮೋದಿ ಅವರು 2020ರ ಜನವರಿ 2ರ ಗುರುವಾರ ಕರ್ನಾಟಕದ ತುಮಕೂರಿನಲ್ಲಿ ನಡೆಯಲಿರುವ ಸಾರ್ವಜನಿಕ ಸಭೆಯಲ್ಲಿ ರಾಜ್ಯಗಳಿಗೆ ಶ್ಲಾಘನೆಯ ಪ್ರಶಸ್ತಿ ಮತ್ತು ಕೃಷಿ ಕರ್ಮಣ್  ಪ್ರಶಸ್ತಿಗಳನ್ನು ಪ್ರದಾನ ಮಾಡಲಿದ್ದಾರೆ.
He will also give away Agriculture Ministers Krishi Karman Awards for Progressive Farmers.	ಅವರು ಕೃಷಿ ಸಚಿವರ ಕೃಷಿ ಕರ್ಮಣ್ ಪ್ರಶಸ್ತಿಗಳನ್ನು ಪ್ರಗತಿಪರ ರೈತರಿಗೆ ಪ್ರದಾನ ಮಾಡಲಿದ್ದಾರೆ.
This will benefit approximately 6 crore beneficiariesrime Minister will also hand over Certificates to beneficiaries under PM Kisan from 8 States/UTs.	ಪ್ರಧಾನಮಂತ್ರಿಯವರು ಪ್ರಧಾನಮಂತ್ರಿ ಕಿಸಾನ್ ಅಡಿಯಲ್ಲಿ 8 ರಾಜ್ಯಗಳು/ಕೇಂದ್ರಡಾಳಿತ ಪ್ರದೇಶಗಳ ಫಲಾನುಭವಿಗಳಿಗೆ ಪ್ರಮಾಣಪತ್ರಗಳನ್ನೂ ಹಸ್ತಾಂತರಿಸಲಿದ್ದಾರೆ.
At the same event, Prime Minister will also handover the Keys of Deep Sea fishing Vessels and Fishing Vessel Transponders to select farmers of Tamil Nadu.	ಇದೇ ಕಾರ್ಯಕ್ರಮದಲ್ಲಿ ಪ್ರಧಾನಂತ್ರಿಯವರು ಆಳ ಸಮುದ್ರದಲ್ಲಿ ಮೀನುಗಾರಿಕೆ ನಡೆಸುವ ಹಡಗುಗಳ ಕೀಗಳು ಮತ್ತು ಮೀನುಗಾರಿಕೆ ಹಡಗುಗಳ ಟ್ರಾನ್ಸ್ ಪಾಂಡರ್ ಗಳನ್ನು ತಮಿಳುನಾಡಿನ ಆಯ್ದ ಮೀನುಗಾರರಿಗೆ ಹಸ್ತಾಂತರಿಸಲಿದ್ದಾರೆ.
He will also distribute Kisan Credit Cards (KCC) to select farmers of Karnataka.	ಕಿಸಾನ್ ಕ್ರಿಡಿಟ್ ಕಾರ್ಡ್ (ಕೆಸಿಸಿ)ಗಳನ್ನು ಸಹ ಅವರು ಕರ್ನಾಟಕದ ಆಯ್ದ ರೈತರಿಗೆ ವಿತರಣೆ ಮಾಡಲಿದ್ದಾರೆ.
The Prime Minister will visit an Exhibition at the venue, and address the gathering.	ಪ್ರಧಾನಮಂತ್ರಿಯವರು ಕಾರ್ಯಕ್ರಮ ಸ್ಥಳದಲ್ಲಿ ವಸ್ತುಪ್ರದರ್ಶನಕ್ಕೆ ಭೇಟಿ ನೀಡಿ, ಸಭಿಕರನ್ನುದ್ದೇಶಿಸಿ ಭಾಷಣ ಮಾಡಲಿದ್ದಾರೆ.
PM dedicates 5 DRDO Young Scientists Laboratories to the Nation	ಪ್ರಧಾನಿಯವರಿಂದ ಐದು ರಕ್ಷಣಾ ಸಂಶೋಧನೆ ಮತ್ತು ಅಭಿವೃದ್ಧಿ ಸಂಸ್ಥೆ (DRDO)  ಯುವ ವಿಜ್ಞಾನಿಗಳ ಪ್ರಯೋಗಾಲಯಗಳ ಲೋಕಾರ್ಪಣೆ
In a boost to indigenous research capabilities in the defence sector, Prime Minister Shri Narendra Modi will dedicate Five DRDO Young Scientists Laboratories to the nation on Thursday January 2, 2020	ರಕ್ಷಣಾ ಕ್ಷೇತ್ರದಲ್ಲಿ ಸ್ಥಳೀಯ ಸಂಶೋಧನಾ ಸಾಮರ್ಥ್ಯಗಳಿಗೆ ಉತ್ತೇಜನ ನೀಡುವ ಸಲುವಾಗಿ ಪ್ರಧಾನಿ ಶ್ರೀ ನರೇಂದ್ರ ಮೋದಿ ಅವರು 2020 ರ ಜನವರಿ 2 ರಂದು ಐದು ರಕ್ಷಣಾ ಸಂಶೋಧನೆ ಮತ್ತು ಅಭಿವೃದ್ಧಿ ಸಂಸ್ಥೆ (DRDO) ಯುವ ವಿಜ್ಞಾನಿಗಳ ಪ್ರಯೋಗಾಲಯಗಳನ್ನು ರಾಷ್ಟ್ರಕ್ಕೆ ಸಮರ್ಪಿಸಲಿದ್ದಾರೆ.
On that occasion, the Prime Minister had also called for involving youth in defence research related activities in a big way, to ensure that India remained abreast of global technological advancements in the field.	ಆ ಸಂದರ್ಭದಲ್ಲಿ, ರಕ್ಷಣಾ ಕ್ಷೇತ್ರದ ಜಾಗತಿಕ ತಾಂತ್ರಿಕ ಪ್ರಗತಿಯಲ್ಲಿ ಭಾರತವು ಸರಿಸಮನಾಗಿದೆ ಎಂಬುದನ್ನು ಖಚಿತಪಡಿಸಿಕೊಳ್ಳಲು, ರಕ್ಷಣಾ ಸಂಶೋಧನಾ ಸಂಬಂಧಿತ ಚಟುವಟಿಕೆಗಳಲ್ಲಿ ಯುವಕರನ್ನು ದೊಡ್ಡ ಪ್ರಮಾಣದಲ್ಲಿ ತೊಡಗಿಸಿಕೊಳ್ಳಬೇಕೆಂದು ಪ್ರಧಾನಿ ಕರೆ ನೀಡಿದ್ದರು.
PM extends greetings on Guru Gobind Singh Jis Prakash Parv	ಶ್ರೀ ಗುರು ಗೋವಿಂದ್ ಸಿಂಗ್ ಜೀಯವರ ಪ್ರಕಾಶ್ ಪರ್ವ್, ಪ್ರಧಾನಿ ಶುಭಾಶಯ
The Prime Minister Shri Narendra Modi has extended his greetings on the occasion of Shri Guru Gobind Singh Jis Prakash Parv today.	ಶ್ರೀ ಗುರು ಗೋವಿಂದ್ ಸಿಂಗ್ ಜೀ ಅವರ ಪ್ರಕಾಶ್ ಪರ್ವ್ ವಾದ ಇಂದು, ಪ್ರಧಾನಮಂತ್ರಿ ಶ್ರೀ ನರೇಂದ್ರ ಮೋದಿ ಅವರು ಶುಭಾಶಯವನ್ನು ಕೋರಿದ್ದಾರೆ.
PM visits Sree Siddaganga Mutt, lays foundation stone for memorial museum of Shri Shri Shivakumar Swamiji	ಸಿದ್ದಗಂಗಾ ಮಠಕ್ಕೆ ಪ್ರಧಾನಮಂತ್ರಿ ಭೇಟಿಶ್ರೀ ಶ್ರೀ ಶಿವಕುಮಾರ ಸ್ವಾಮೀಜಿ ಸ್ಮಾರಕ ವಸ್ತು ಸಂಗ್ರಹಾಲಯಕ್ಕೆ ಶಂಕುಸ್ಥಾಪನೆ
PM to lay Foundation Stone for Memorial Museum of Shri Shri Shivakumar Swamiji	ಶ್ರೀ ಶ್ರೀ ಶಿವಕುಮಾರ ಸ್ವಾಮೀಜಿ ಸ್ಮಾರಕ ವಸ್ತು ಸಂಗ್ರಹಾಲಯಕ್ಕೆ ಶಂಕುಸ್ಥಾಪನೆ
Prime Minister Shri Narendra Modi visited the Shri Siddhaganga Mutt in Tumkuru, Karnataka and laid the foundation stone for a memorial museum of Shri Shri Shivakumar Swamiji.	ಪ್ರಧಾನಮಂತ್ರಿ  ಶ್ರೀ ನರೇಂದ್ರ ಮೋದಿ ಅವರು ಕರ್ನಾಟಕದ ತುಮಕೂರು ಬಳಿಯ ಶ್ರೀ ಸಿದ್ಧಗಂಗಾಮಠಕ್ಕೆ ಭೇಟಿ ನೀಡಿ, ಶ್ರೀ ಶ್ರೀ ಶಿವಕುಮಾರ ಸ್ವಾಮೀಜಿ ಸ್ಮಾರಕ ವಸ್ತುಸಂಗ್ರಹಾಲಯಕ್ಕೆ ಶಂಕುಸ್ಥಾಪನೆ ನೆರವೇರಿಸಿದರು.
PM Modi while addressing at Shri Siddhaganga Mutt in Tumkuru, said he is fortunate that he is beginning the year 2020 from such pious lande wished that the sacred energy of Sree Siddaganga Mutt enriches the lives of the people of our country.	ತುಮಕೂರು ಶ್ರೀ ಸಿದ್ದಗಂಗಾ ಮಠದಲ್ಲಿ ಮಾತನಾಡಿದ ಅವರು, ತಾವು ಈ ಪವಿತ್ರ ಭೂಮಿಯಿಂದ 2020ನ್ನು ಆರಂಭಿಸುತ್ತಿರುವುದು ತಮ್ಮ ಸುದೈವ ಎಂದು ಹೇಳಿದರು.
With his inspiring personality this holy place has been giving direction to the society for decades.	ಅವರ ಸ್ಫೂರ್ತಿದಾಯಕ ವ್ಯಕ್ತಿತ್ವದಿಂದಾಗಿ ಈ ಪವಿತ್ರ ಭೂಮಿ ದಶಕಗಳಿಂದ ಸಮಾಜಕ್ಕೆ ಮಾರ್ಗದರ್ಶನ ಮಾಡುತ್ತಿದೆ ಎಂದರು.
This museum will not only inspire people, but will also serve to give direction to the society and country.	ಈ ವಸ್ತುಸಂಗ್ರಹಾಲಯ ಕೇವಲ ಜನರಿಗೆ ಸ್ಫೂರ್ತಿಯನ್ನಷ್ಟೇ ನೀಡುವುದಿಲ್ಲ, ಜೊತೆಗೆ ದೇಶಕ್ಕೆ ಮತ್ತು ಸಮಾಜಕ್ಕೆ ದಿಕ್ಕು ತೋರಿಸುತ್ತದೆ ಎಂದರು.
Prime Minister said that India has entered the third decade of the 21st century with new energy and renewed vigor.	ಭಾರತವು 21ನೇ ಶತಮಾನದ 3ನೇ ದಶಕಕ್ಕೆ ಹೊಸ ಚೈತನ್ಯ ಮತ್ತು  ಶಕ್ತಿಯೊಂದಿಗೆ ಕಾಲಿಟ್ಟಿದೆ ಎಂದು ಪ್ರಧಾನಮಂತ್ರಿಯವರು ಹೇಳಿದರು.
This is the thinking of young India.	ನವ ಭಾರತದ ಆಶಯ ಇದಾಗಿದೆ.
This aspiration is of young dreams	ಈ ಆಶಯ ಯುವಜನರ ಕನಸಾಗಿದೆ.
This is the aspiration of the sisters and daughters of the country	ಇದು ದೇಶದ ಸೋದರಿಯರ ಮತ್ತು ಹೆಣ್ಣು ಮಕ್ಕಳ ಆಶಯವೂ ಆಗಿದೆ.
This aspiration is for the poor, downtrodden, deprived, afflicted, backward, tribals of the country.	ಇದೇ ಆಶಯ ದೇಶದ ಬಡವರು, ವಂಚಿತರು, ದುರ್ಬಲರು, ಹಿಂದುಳಿದವರು, ಬುಡಕಟ್ಟು ಜನರದ್ದೂ ಆಗಿದೆ ಎಂದರು.
This message emanating from the society also inspires, encourages our government.	ಈ ಸಂದೇಶ ಸಮಾಜದಿಂದ ಹೊರಹೊಮ್ಮುತ್ತಿದ್ದು, ನಮ್ಮ ಸರ್ಕಾರಕ್ಕೂ ಸ್ಫೂರ್ತಿ ನೀಡುತ್ತಿದೆ ಎಂದರು.
Prime Minister said that people fled from Pakistan to India, to save their lives, to save the lives of their daughters.	ತಮ್ಮ ಪ್ರಾಣ ಉಳಿಸಿಕೊಳ್ಳಲು, ತಮ್ಮ ಹೆಣ್ಣುಮಕ್ಕಳ ಜೀವ ಉಳಿಸಲು ಪಾಕಿಸ್ತಾನದಿಂದ ಭಾರತಕ್ಕೆ ಜನರು ಓಡಿ ಬಂದಿದ್ದಾರೆ ಎಂದು ಪ್ರಧಾನಮಂತ್ರಿ ಹೇಳಿದರು.
He further said that every countrymen has a question as to why people dont speak against Pakistan and instead processions are being taken out against these people.	ಜನರು ಪಾಕಿಸ್ತಾನದ ವಿರುದ್ಧ ಏಕೆ ಮಾತನಾಡುವುದಿಲ್ಲ ಮತ್ತು ಇದರ ಬದಲಾಗಿ ಈ ಜನರ ವಿರುದ್ಧ ಮೆರವಣಿಗೆಗಳನ್ನು ನಡೆಸಲಾಗುತ್ತಿದೆ ಎಂಬ ಪ್ರಶ್ನೆ ಪ್ರತಿಯೊಬ್ಬ ದೇಶವಾಸಿಗಳಿಗೂ ಇದೆ ಎಂದು ಅವರು ಹೇಳಿದರು.
To those who are agitating against the Parliament of India, Prime Minister said, If you have to agitate, raise your voice against the exploits of Pakistan in the last 70 years	ಭಾರತದ ಸಂಸತ್ತಿನ ವಿರುದ್ಧ ಪ್ರತಿಭಟನೆ ನಡೆಸುತ್ತಿರುವವರ ಬಗ್ಗೆ ಮಾತನಾಡಿದ ಪ್ರಧಾನಮಂತ್ರಿ “ನೀವು ಪ್ರತಿಭಟನೆ ಮಾಡುವುದಿದ್ದರೆ, ಕಳೆದ 70 ವರ್ಷಗಳಲ್ಲಿ ಪಾಕಿಸ್ತಾನದಲ್ಲಿ ಆಗಿರುವ ಶೋಷಣೆಯ ವಿರುದ್ಧ ಧ್ವನಿ ಎತ್ತಿ.
First, to reinforce Indias ancient culture of giving importance to every individuals duties and obligations.	ಮೊದಲನೆಯದಾಗಿ, ಪ್ರತಿಯೊಬ್ಬ ವ್ಯಕ್ತಿಯ ಕರ್ತವ್ಯಗಳು ಮತ್ತು ಕಟ್ಟುಪಾಡುಗಳಿಗೆ ಪ್ರಾಮುಖ್ಯತೆ ನೀಡುವ ಭಾರತದ ಪ್ರಾಚೀನ ಸಂಸ್ಕೃತಿಯನ್ನು ಪುನಶ್ಚೈತನ್ಯಗೊಳಿಸಿ.
Second, to protect nature and the environment.	ಎರಡನೆಯದಾಗಿ, ಪ್ರಕೃತಿ ಮತ್ತು ಪರಿಸರವನ್ನು ಸಂರಕ್ಷಿಸಲು ಸಂಕಲ್ಪಿಸಿ
And third, to cooperate in public awareness for water conservation, water harvesting.	ಮತ್ತು ಮೂರನೆಯದಾಗಿ, ನೀರಿನ ಸಂರಕ್ಷಣೆ, ನೀರಿನ ಕೊಯ್ಲುಗಾಗಿ ಸಾರ್ವಜನಿಕರಲ್ಲಿ ಜಾಗೃತಿ ಮೂಡಿಸಲು ಸಹಕರಿಸಿ.
He said that India has always viewed saints, sages, gurus as a lighthouse for the right path.	ಭಾರತವು ಸದಾ ಸಂತರು, ಋಷಿ ಮುನಿಗಳು, ಗುರುಗಳನ್ನು ಸರಿ ದಾರಿಯಲ್ಲಿ ಕರೆದೊಯ್ಯುವ ದೀಪಸ್ತಂಭದಂತೆ ನೋಡಿದೆ ಎಂದು ಹೇಳಿದರು.
PM to inaugurate 107th Indian Science Congress tomorrow at UAS, Bangalore	ನಾಳೆ ಬೆಂಗಳೂರಿನ ಕೃಷಿ ವಿಶ್ವವಿದ್ಯಾಲಯದಲ್ಲಿ (ಯುಸ್) 107ನೇ ಭಾರತೀಯ ವಿಜ್ಞಾನ ಕಾಂಗ್ರೆಸ್ ಉದ್ಘಾಟಿಸಲಿರುವ ಪ್ರಧಾನ ಮಂತ್ರಿ
Prime Minister inaugurates 107th Indian Science Congress	ಎ ಸ್) 107ನೇ ಭಾರತೀಯ ವಿಜ್ಞಾನ ಕಾಂಗ್ರೆಸ್ ಉದ್ಘಾಟಿಸಲಿರುವ ಪ್ರಧಾನ ಮಂತ್ರಿ
The Prime Minister Shri Narendra Modi will inaugurate 107thIndian Science Congress at University of Agricultural Sciences, GKVK, Bengaluru on Friday 3 January 2020	ಪ್ರಧಾನಮಂತ್ರಿ ಶ್ರೀ ನರೇಂದ್ರ ಮೋದಿ ಅವರು, ನಾಳೆ 2020ರ ಜನವರಿ 3ರಂದು ಶುಕ್ರವಾರ ಬೆಂಗಳೂರಿನ, ಜಿಕೆವಿಕೆ, ಕೃಷಿ ವಿಶ್ವವಿದ್ಯಾಲಯದಲ್ಲಿ 107ನೇ ಭಾರತೀಯ ವಿಜ್ಞಾನ ಕಾಂಗ್ರೆಸ್ ಉದ್ಘಾಟಿಸಲಿದ್ದಾರೆ.
The Theme of the India Science Congress (ISC) this year is Science and Technology: Rural Development	ಈ ಬಾರಿಯ ಭಾರತೀಯ ವಿಜ್ಞಾನ ಕಾಂಗ್ರೆಸ್ ನ (ಐ ಸ್ ಿವಿಷಯ “ವಿಜ್ಞಾನ ಮತ್ತು ತಂತ್ರಜ್ಞಾನ: ಗ್ರಾಮೀಣಾಭಿವೃದ್ಧಿ’ ಎಂಬುದಾಗಿದೆ.
PM to release 3rd installment of Rs 2000 to 6 crore beneficiaries under PM KISAN	ಪ್ರಧಾನಮಂತ್ರಿ ಕಿಸಾನ್ ಅಡಿಯಲ್ಲಿ 6 ಕೋಟಿ ಫಲಾನುಭವಿಗಳಿಗೆ 2000 ರೂ.
Prime Minister Shri Narendra Modi distributed Agriculture Ministers Krishi Karman Awards for Progressive Farmers and Commendation Awards to the states at a public meeting in Tumkur, Karnataka today	ಪ್ರಧಾನಮಂತ್ರಿ ಶ್ರೀ ನರೇಂದ್ರ ಮೋದಿ ಅವರು ಇಂದು ಕರ್ನಾಟಕದ ತುಮಕೂರಿನಲ್ಲಿ ನಡೆದ ಸಾರ್ವಜನಿಕ ಸಭೆಯಲ್ಲಿ ಪ್ರಗತಿಪರ ರೈತರಿಗಾಗಿ ಕೃಷಿ ಸಚಿವರ ಕೃಷಿ ಕರ್ಮಣ್ ಪ್ರಶಸ್ತಿಗಳು ಮತ್ತು ರಾಜ್ಯಗಳಿಗೆ ಪ್ರಶಂಸಾ ಪ್ರಶಸ್ತಿಗಳನ್ನು ವಿತರಿಸಿದರು.
He also released the 3rd installment of PM Kisan (Pradhan Mantri Kisan Samman Nidhi) of Rs 2000 for the period December 2019 - March 2020	ಅವರು ಪಿಎಂ ಕಿಸಾನ್ (ಪ್ರಧಾನ್ ಮಂತ್ರಿ ಕಿಸಾನ್ ಸಮ್ಮಾನ್ ನಿಧಿ) ಯ ಡಿಸೆಂಬರ್ 2019 - ಮಾರ್ಚ್ 2020 ರ ಅವಧಿಯ 3 ನೇ ಕಂತು ಬಿಡುಗಡೆ ಮಾಡಿದರು.
He will also distribute Kisan Credit Cards (KCC) to select farmers of Karnataka.	ಕರ್ನಾಟಕದ ಆಯ್ದ ರೈತರಿಗೆ ಕಿಸಾನ್ ಕ್ರೆಡಿಟ್ ಕಾರ್ಡ್‌ಗಳನ್ನು (ಕೆಸಿಸಿ) ವಿತರಿಸಿದರು.
Prime Minister also handed over the keys of Deep Sea fishing Vessels and Fishing Vessel Transponders to select farmers of Tamil Nadu.	ತಮಿಳುನಾಡಿನ ಆಯ್ದ ಮೀನುಗಾರಿಗೆ ಆಳ ಸಮುದ್ರದ ಮೀನುಗಾರಿಕಾ ಹಡಗುಗಳು ಮತ್ತು ಮೀನುಗಾರಿಕೆ ಹಡಗು ಟ್ರಾನ್ಸ್‌ಪಾಂಡರ್‌ಗಳ ಕೀಲಿಗಳನ್ನು ಪ್ರಧಾನಿಯವರು ಹಸ್ತಾಂತರಿಸಿದರು.
On behalf of 130 crore countrymen, the Prime Minister thanked ther countrys farmers for their toil.	ಅವರ ಶ್ರಮಕ್ಕಾಗಿ ದೇಶದ ರೈತರಿಗೆ 130 ಕೋಟಿ ಜನರ ಪರವಾಗಿ ಪ್ರಧಾನಮಂತ್ರಿಯವರು ಧನ್ಯವಾದ ಅರ್ಪಿಸಿದರು.
The Prime Minister said that the land of Karnataka also witnessed a historic moment when money under the PM-Kisan scheme has been distributed directly into the personal accounts of nearly 6 Crore Farmers in the country	ಪಿಎಂ ಕಿಸಾನ್ ಯೋಜನೆಯಡಿ ಹಣವನ್ನು ದೇಶದ ಸುಮಾರು 6 ಕೋಟಿ ರೈತರ ವೈಯಕ್ತಿಕ ಖಾತೆಗಳಿಗೆ ನೇರವಾಗಿ ವಿತರಿಸಿದ ಐತಿಹಾಸಿಕ ಕ್ಷಣಕ್ಕೆ ಕರ್ನಾಟಕದ ನೆಲ ಕೂಡ ಸಾಕ್ಷಿಯಾಗಿದೆ ಎಂದು ಪ್ರಧಾನಿ ಹೇಳಿದರು.
Prime Minister said a total of Rs 12 Thousand Crores has been deposited under the 3rd tranche of the scheme.	ಯೋಜನೆಯ 3 ನೇ ಹಂತದ ಅಡಿಯಲ್ಲಿ ಒಟ್ಟು 12 ಸಾವಿರ ಕೋಟಿ ರೂ.
He hoped that the States that havent implemented the PM Kisan Samman Nidhi Yojana, will do it and political parties will rise over politics to help the farmers in their States.	ಪಿಎಂ ಕಿಸಾನ್ ಸಮ್ಮಾನ್ ನಿಧಿ ಯೋಜನೆಯನ್ನು ಜಾರಿಗೊಳಿಸದ ರಾಜ್ಯಗಳು ಇದನ್ನು ಅನುಷ್ಠಾನಗೊಳಿಸಲಿವೆ ಮತ್ತು ರಾಜಕೀಯ ಪಕ್ಷಗಳು ತಮ್ಮ ರಾಜ್ಯಗಳಲ್ಲಿನ ರೈತರಿಗೆ ಸಹಾಯ ಮಾಡಲು ರಾಜಕೀಯದಿಂದಾಚೆ ಬರಲಿವೆ ಎಂದು ಅವರು ಆಶಿಸಿದರು.
PM recalled that there was also a period in the country, when one rupee was sent for the poor in the country and only 15 paise out of it reached the beneficiaries	ದೇಶದಲ್ಲಿ ಬಡವರಿಗೆ ಒಂದು ರೂಪಾಯಿ ಕಳುಹಿಸಿದರೆ, ಅದರಲ್ಲಿ ಕೇವಲ 15 ಪೈಸೆ ಮಾತ್ರ ಫಲಾನುಭವಿಗಳಿಗೆ ತಲುಪುತ್ತಿದ್ದ ಕಾಲವೊಂದಿತ್ತು ಎಂದು ನೆನಪಿಸಿಕೊಂಡ ಪ್ರಧಾನಿಯವರು, ಈಗ ಮಧ್ಯವರ್ತಿಗಳ ಹಸ್ತಕ್ಷೇಪವಿಲ್ಲದೆ ನೇರವಾಗಿ ಬಡವರಿಗೆ ಹಣ ತಲುಪುತ್ತಿದೆ ಎಂದರು.
He also said that the centre has always given priority to the interests of our farmers with the schemes like crop insurance, soil health cards and 100% neem coated urea.	100 ಬೇವು ಲೇಪಿತ ಯೂರಿಯಾ ಮುಂತಾದ ಯೋಜನೆಗಳೊಂದಿಗೆ ಕೇಂದ್ರವು ನಮ್ಮ ರೈತರ ಹಿತಾಸಕ್ತಿಗೆ ಯಾವಾಗಲೂ ಆದ್ಯತೆ ನೀಡಿದೆ ಎಂದು ಅವರು ಹೇಳಿದರು.
Spice production in India has increased by more than 2million tons, so the export has also increased from about Rs 15 thousand crore to about Rs 19 thousand crore.	ಭಾರತದಲ್ಲಿ ಮಸಾಲೆ ಪದಾರ್ಥಗಳ ಉತ್ಪಾದನೆಯು 2 ದಶಲಕ್ಷ ಟನ್‌ಗಳಿಗಿಂತ ಹೆಚ್ಚಾಗಿದೆ, ಆದ್ದರಿಂದ ರಫ್ತು ಸುಮಾರು 15 ಸಾವಿರ ಕೋ ೂ ಳಿಂದ 19 ಸಾವಿರ ಕೋ.
He said that apart from horticulture, South India also has a large share in the production of pulses, oil and coarse grains.	ತೋಟಗಾರಿಕೆಯನ್ನು ಹೊರತುಪಡಿಸಿ, ದ್ವಿದಳ ಧಾನ್ಯಗಳು, ತೈಲ ಮತ್ತು ಒರಟು ಧಾನ್ಯಗಳ ಉತ್ಪಾದನೆಯಲ್ಲಿ ದಕ್ಷಿಣ ಭಾರತಕ್ಕೂ ಹೆಚ್ಚಿನ ಪಾಲು ಇದೆ ಎಂದು ಅವರು ಹೇಳಿದರು.
Prime Minister said, Seed hubs have been built to promote pulses production in India, of which more than 30 centers are located in Karnataka, Andhra, Kerala, Tamil Nadu and Telangana itself.	ಭಾರತದಲ್ಲಿ ದ್ವಿದಳ ಧಾನ್ಯಗಳ ಉತ್ಪಾದನೆಯನ್ನು ಉತ್ತೇಜಿಸಲು ಬೀಜ ಕೇಂದ್ರಗಳನ್ನು ನಿರ್ಮಿಸಲಾಗಿದೆ, ಅದರಲ್ಲಿ 30 ಕ್ಕೂ ಹೆಚ್ಚು ಕೇಂದ್ರಗಳು ಕರ್ನಾಟಕ, ಆಂಧ್ರ, ಕೇರಳ, ತಮಿಳುನಾಡು ಮತ್ತು ತೆಲಂಗಾಣದಲ್ಲಿಯೇ ಇವೆಎಂದು ಪ್ರಧಾನಿ ಹೇಳಿದರು.
Referring to the Governments efforts on Fisheries sector, Prime Minister said the government is working at three levels to strengthen the sector.	ಮೀನುಗಾರಿಕೆ ಕ್ಷೇತ್ರದ ಬಗ್ಗೆ ಸರ್ಕಾರದ ಪ್ರಯತ್ನಗಳನ್ನು ಉಲ್ಲೇಖಿಸಿದ ಪ್ರಧಾನಿಯವರು, ಈ ವಲಯವನ್ನು ಬಲಪಡಿಸಲು ಸರ್ಕಾರ ಮೂರು ಹಂತಗಳಲ್ಲಿ ಕಾರ್ಯನಿರ್ವಹಿಸುತ್ತಿದೆ ಎಂದು ಹೇಳಿದರು.
First - Encouraging fisheries in villages through financial assistance to fishermen.	ಮೊದಲನೆಯದು - ಮೀನುಗಾರರಿಗೆ ಆರ್ಥಿಕ ನೆರವು ನೀಡುವ ಮೂಲಕ ಗ್ರಾಮಗಳಲ್ಲಿ ಮೀನುಗಾರಿಕೆಯನ್ನು ಪ್ರೋತ್ಸಾಹಿಸುವುದು.
Second- Modernizing the fishing boats under the Blue Revolution Scheme.	ಎರಡನೆಯದು- ನೀಲಿ ಕ್ರಾಂತಿ ಯೋಜನೆಯಡಿ ಮೀನುಗಾರಿಕೆ ದೋಣಿಗಳನ್ನು ಆಧುನೀಕರಿಸುವುದು.
And third - Constructing modern infrastructure related to fish trade and business.	ಮತ್ತು ಮೂರನೆಯದು - ಮೀನು ವ್ಯಾಪಾರ ಮತ್ತು ವ್ಯವಹಾರಕ್ಕೆ ಸಂಬಂಧಿಸಿದ ಆಧುನಿಕ ಮೂಲಸೌಕರ್ಯಗಳನ್ನು ನಿರ್ಮಿಸುವುದು.
New fishing harbours are being built in large rivers and in the sea for the convenience of fish farmers	ಮೀನಗಾರರ ಅನುಕೂಲಕ್ಕಾಗಿ ದೊಡ್ಡ ನದಿಗಳಲ್ಲಿ ಮತ್ತು ಸಮುದ್ರದಲ್ಲಿ ಹೊಸ ಮೀನುಗಾರಿಕೆ ಬಂದರುಗಳನ್ನು ನಿರ್ಮಿಸಲಾಗುತ್ತಿದೆ.
Fishermens boats are being modernized for deep sea fishing and navigation devices are being installed in boats for the protection of fishermen with the help of ISRO.	ಆಳ ಸಮುದ್ರದ ಮೀನುಗಾರಿಕೆಗಾಗಿ ಮೀನುಗಾರರ ದೋಣಿಗಳನ್ನು ಆಧುನೀಕರಿಸಲಾಗುತ್ತಿದೆ ಮತ್ತು ಇಸ್ರೊ ಸಹಾಯದಿಂದ ಮೀನುಗಾರರ ರಕ್ಷಣೆಗಾಗಿ ದೋಣಿಗಳಲ್ಲಿ ಸಂಚರಣೆ (ನ್ಯಾವಿಗೇಷನ್) ಸಾಧನಗಳನ್ನು ಅಳವಡಿಸಲಾಗುತ್ತಿದೆ ” ಎಂದು ಪ್ರಧಾನಿ ಹೇಳಿದರು.
This will give impetus to people and states doing better work in these areas, he added.	ಇದು ಈ ಕ್ಷೇತ್ರಗಳಲ್ಲಿ ಉತ್ತಮ ಕೆಲಸ ಮಾಡುವವರಿಗೆ ಮತ್ತು ರಾಜ್ಯಗಳಿಗೆ ಉತ್ತೇಜನ ನೀಡುತ್ತದೆ ಎಂದು ಹೇಳಿದರು.
PM to dedicate Five DRDO Young Scientists Laboratories to the nation	ಐದು ಯುವ ವಿಜ್ಞಾನಿ ರಕ್ಷಣಾ ಸಂಶೋಧನೆ ಮತ್ತು ಅಭಿವೃದ್ಧಿ ಸಂಸ್ಥೆ (ಡಿ ರ್ ಿ ) ಪ್ರಯೋಗಾಲಯಗಳನ್ನು ರಾಷ್ಟ್ರಕ್ಕೆ ಸಮರ್ಪಿಸಿದ ಪ್ರಧಾನಮಂತ್ರಿ
Shri Narendra Modi had then asked DRDO to empower the youth, by giving them decision making powers and challenging research opportunities.	ಅಂದು ಶ್ರೀ ನರೇಂದ್ರ ಮೋದಿ ಅವರು ಡಿಆರ್ ಿೆ ಯುವಜನರನ್ನು ಸಬಲೀಕರಿಸಲು, ಅವರಿಗೆ ನಿರ್ಧಾರ ಕೈಗೊಳ್ಳುವ ಅಧಿಕಾರ ಮತ್ತು ಸಂಶೋಧನಾ ಅವಕಾಶಗಳ ಸವಾಲು ನೀಡುವಂತೆ ಸೂಚಿಸಿದ್ದರು.
Prime Minister asked the scientists to prepare a definite roadmap for the new decade where DRDO should be able to set the direction and pace of scientific research in various fields in India.	ಹೊಸ ದಶಕಕ್ಕೆ ನಿರ್ದಿಷ್ಟವಾದ ಮಾರ್ಗಸೂಚಿಯನ್ನು ರೂಪಿಸುವಂತೆ, ವಿಜ್ಞಾನಿಗಳಿಗೆ ಕರೆ ನೀಡಿದ ಪ್ರಧಾನಮಂತ್ರಿಗಳು, ಅಲ್ಲಿ ಭಾರತದ ವಿವಿಧ ಕ್ಷೇತ್ರಗಳಲ್ಲಿ ವೈಜ್ಞಾನಿಕ ಸಂಸೋಧನೆಗೆ ವೇಗ ಮತ್ತು ದಿಕ್ಕು ತೋರಿಸಲು ಡಿ ರ್ ಿಾಧ್ಯವಾಗುವಂತಿರಬೇಕು ಎಂದರು.
Addressing the scientists, Prime Minister said Indias Missile programme is one of the outstanding programmes in the world	ವಿಜ್ಞಾನಿಗಳನ್ನು ಉದ್ದೇಶಿಸಿ ಮಾತನಾಡಿದ ಪ್ರಧಾನಮಂತ್ರಿಯವರು, ಭಾರತದ ಕ್ಷಿಪಣಿ ಕಾರ್ಯಕ್ರಮ ವಿಶ್ವದಲ್ಲಿನ ಅತ್ಯುತ್ತಮ ಕಾರ್ಯಕ್ರಮಗಳಲ್ಲಿ ಒಂದಾಗಿದೆ ಎಂದರು.
He also appreciated the Indian Space Programme and air defence systems.	ಭಾರತೀಯ ಬಾಹ್ಯಾಕಾಶ ಕಾರ್ಯಕ್ರಮ ಮತ್ತು ವಾಯು ರಕ್ಷಣೆ ವ್ಯವಸ್ಥೆಯನ್ನು ಅವರು ಶ್ಲಾಘಿಸಿದರು.
Prime Minister said India cannot be left behind in the field of scientific research	ಭಾರತವು ವೈಜ್ಞಾನಿಕ ಸಂಶೋಧನೆಯ ಕ್ಷೇತ್ರದಲ್ಲಿ ಎಂದಿಗೂ ಹಿಂದೆ ಬೀಳಬಾರದು ಎಂದು ಪ್ರಧಾನಮಂತ್ರಿಯವರು ಹೇಳಿದರು.
He said the Government is willing to walk the extra mile with the scientific community so that it can invest time in emerging technologies and innovations for national security.	ರಾಷ್ಟ್ರೀಯ ಭದ್ರತೆಗಾಗಿ ಉದಯೋನ್ಮುಖ ತಂತ್ರಜ್ಞಾನಗಳು ಮತ್ತು ನಾವೀನ್ಯತೆಗಳಲ್ಲಿ ಸಮಯವನ್ನು ಹೂಡಿಕೆ ಮಾಡಲು, ವೈಜ್ಞಾನಿಕ ಸಮುದಾಯದೊಂದಿಗೆ ಹೆಚ್ಚುವರಿ ಮೈಲಿಗಳಲ್ಲಿ ಸಾಗಲು ಸರ್ಕಾರವು ಸಿದ್ಧವಾಗಿದೆ ಎಂದು ಅವರು ಹೇಳಿದರು ಿ ರ್ ಿನಾವಿನ್ಯತೆಗಳು ಮೇಕ್ ಇನ್ ಇಂಡಿಯಾದಂಥ ಕಾರ್ಯಕ್ರಮಗಳನ್ನು ಬಲಪಡಿಸುವಲ್ಲಿ ಮತ್ತು ದೇಶದಲ್ಲಿ ಚಲನಶೀಲ ರಕ್ಷಣಾ ವಲಯದ ಉತ್ತೇಜನದಲ್ಲಿ ಮಹತ್ವದ ಪಾತ್ರ ವಹಿಸುತ್ತವೆ  ಎಂದು ಪ್ರಧಾನಮಂತ್ರಿಯವರು ಹೇಳಿದರು.
The establishment of the five DRDO Young Scientist Labs lays down the foundation for research and development of futuristic technologies	ಐದು ಡಿ ರ್ ಿುವ ವಿಜ್ಞಾನಿಗಳ ಪ್ರಯೋಗಾಲಯ ಸ್ಥಾಪನೆಯು ಭವಿಷ್ಯದ ತಂತ್ರಜ್ಞಾನಗಳ ಸಂಶೋಧನೆ ಮತ್ತು ಅಭಿವೃದ್ಧಿಗೆ ನಾಂದಿ ಹಾಡುತ್ತದೆ ಎಂದರು.
It will be a big leap forward for DRDO from the goal of making India self reliant to future ready in defence technologies.	ಇದು ಭವಿಷ್ಯದ ರಕ್ಷಣಾ ತಂತ್ರಜ್ಞಾನದಲ್ಲಿ ಭಾರತವನ್ನು ಸ್ವಾವಲಂಬಿಯನ್ನಾಗಿರುವ ಗುರಿಯತ್ತ ಡಿ ರ್ ಿದೊಡ್ಡ ದಾಪುಗಾಲಾಗಿದೆ ಎಂದರು.
The research in the hot and critical area of Smart Materials and their applications will be based out of Hyderabad.	ಪ್ರಮುಖ ಕ್ಷೇತ್ರವಾದ ಸ್ಮಾರ್ಟ್ ಮೆಟೀರಿಯಲ್ ಮತ್ತು ಅದರ ಆನ್ವಯಿಕಗಳ ಸಂಶೋಧನೆ ಹೈದ್ರಾಬಾದ್ ನಲ್ಲಿರಲಿದೆ.
PM pays tributes to Savitribai Phule on her Jayanti	ಸಾವಿತ್ರಿಬಾಯಿ ಫುಲೆ ಜಯಂತಿ: ಪ್ರಧಾನಮಂತ್ರಿ ಗೌರವ ನಮನ
The Prime Minister, Shri Narendra Modi has paid tributes to Savitribai Phule on her Jayanti.	ಶ್ರೀಮತಿ ಸಾವಿತ್ರಿಬಾಯಿ ಫುಲೆ ಅವರ ಜಯಂತಿಯಂದು ಪ್ರಧಾನಮಂತ್ರಿ ಶ್ರೀ ನರೇಂದ್ರ ಮೋದಿ ಅವರು ಗೌರವ ನಮನ ಸಲ್ಲಿಸಿದರು.
Prime Minister inaugurates 107th Indian Science Congress	107 ನೇ ಭಾರತೀಯ ವಿಜ್ಞಾನ ಕಾಂಗ್ರೆಸ್ ಉದ್ಘಾಟನೆಯಲ್ಲಿ ಪ್ರಧಾನ ಮಂತ್ರಿಯವರ ಭಾಷಣ
Friends, first and foremost I wish you all a happy 2020	ಸ್ನೇಹಿತರೇ, ಮೊದಲನೆಯದಾಗಿ ನಿಮ್ಮೆಲ್ಲರಿಗೂ 2020 ರ ಶುಭಾಶಯಗಳು.
May this year be marked by prosperity in your lives and productivity in your labs	ಈ ವರ್ಷವು ನಿಮ್ಮ ಜೀವನದಲ್ಲಿ ಸಮೃದ್ಧಿ ಮತ್ತು ನಿಮ್ಮ ಪ್ರಯೋಗಾಲಯಗಳಲ್ಲಿ ಉತ್ಪಾದಕತೆಯನ್ನು ತರಲಿ.
I am particularly happy that one of my first programmes in the start of a new-year and new decade is linked to science, technology and innovation	ನೂತನ ವರ್ಷ ಮತ್ತು ದಶಕದ ಆರಂಭದಲ್ಲಿ ನನ್ನ ಮೊದಲ ಕಾರ್ಯಕ್ರಮ ವಿಜ್ಞಾನ, ತಂತ್ರಜ್ಞಾನ ಮತ್ತು ಆವಿಷ್ಕಾರಕ್ಕೆ ಸಂಬಂಧಿಸಿದ್ದಾಗಿದೆ ಎಂಬುದು ನನಗೆ ವಿಶೇಷ ಸಂತೋಷ ತಂದಿದೆ.
This programme is happening in Bengaluru, a city linked with science and innovation	ವಿಜ್ಞಾನ ಮತ್ತು ಆವಿಷ್ಕಾರಕ್ಕೆ ಸಂಬಂಧಿಸಿರುವ ನಗರವಾದ ಬೆಂಗಳೂರಿನಲ್ಲಿ ಈ ಕಾರ್ಯಕ್ರಮ ನಡೆಯುತ್ತಿದೆ.
That time, the manner in which our nation celebrated science, our space programme and the strengths of our scientists will always be a part of my memory.	ಆ ಸಮಯದಲ್ಲಿ, ನಮ್ಮ ರಾಷ್ಟ್ರವು ವಿಜ್ಞಾನವನ್ನು ಸಂಭ್ರಮಿಸಿದ ರೀತಿ, ನಮ್ಮ ಬಾಹ್ಯಾಕಾಶ ಕಾರ್ಯಕ್ರಮ ಮತ್ತು ನಮ್ಮ ವಿಜ್ಞಾನಿಗಳ ಸಾಮರ್ಥ್ಯಗಳು ಯಾವಾಗಲೂ ನನ್ನ ನೆನಪಿನ ಒಂದು ಭಾಗವಾಗಿರುತ್ತವೆ.
Friends, Bengaluru the city of gardensis now a wonderful field for start-ups	ಸ್ನೇಹಿತರೇ, ಉದ್ಯಾನ ನಗರಿ ಬೆಂಗಳೂರು, ಈಗ ಸ್ಟಾರ್ಟ್ ಅಪ್‌ಗಳಿಗೆ ಅದ್ಭುತ ಕ್ಷೇತ್ರವಾಗಿದೆ.
The world is coming to innovate here	ಜಗತ್ತೇ ಇಲ್ಲಿಗೆ ಹೊಸತನಕ್ಕಾಗಿ ಬರುತ್ತಿದೆ.
And hence, when we start year 2020 with positivity and optimism of science and technology driven development, we take one more step in fulfilling our dream.	ಆದ್ದರಿಂದ, ನಾವು ವಿಜ್ಞಾನ ಮತ್ತು ತಂತ್ರಜ್ಞಾನ ಚಾಲಿತ ಅಭಿವೃದ್ಧಿಯ ಸಕಾರಾತ್ಮಕತೆ ಮತ್ತು ಆಶಾವಾದದೊಂದಿಗೆ 2020 ನೇ ವರ್ಷವನ್ನು ಪ್ರಾರಂಭಿಸಿದಾಗ, ನಮ್ಮ ಕನಸನ್ನು ಈಡೇರಿಸುವಲ್ಲಿ ನಾವು ಇನ್ನೂ ಒಂದು ಹೆಜ್ಜೆ ಮುಂದಿಡುತ್ತೇವೆ.
I am also happy to learn that Indias ranking has improved in the Innovation Index to 52	ನಾವೀನ್ಯತೆಯ ಸೂಚ್ಯಂಕದಲ್ಲಿ ಭಾರತದ ಶ್ರೇಯಾಂಕವು 52 ಕ್ಕೆ ಸುಧಾರಿಸಿದೆ ಎಂಬುದು ನನಗೆ ಸಂತಸ ತಂದಿದೆ.
The growth story of India depends on its achievements in the Science & Technology sector	ಭಾರತದ ಪ್ರಗತಿಯು ವಿಜ್ಞಾನ ಮತ್ತು ತಂತ್ರಜ್ಞಾನ ಕ್ಷೇತ್ರದಲ್ಲಿ ಸಾಧನೆಗಳ ಮೇಲೆ ಅವಲಂಬಿತವಾಗಿದೆ.
There is a need to revolutionise the landscape of Indian Science Technology and Innovation.	ಭಾರತೀಯ ವಿಜ್ಞಾನ, ತಂತ್ರಜ್ಞಾನ ಮತ್ತು ಆವಿಷ್ಕಾರದ ಕ್ಷೇತ್ರದಲ್ಲಿ ಕ್ರಾಂತಿಯುಂಟುಮಾಡುವ ಅವಶ್ಯಕತೆಯಿದೆ.
My motto for the young scientists bourgeoning in this country has been -Innovate, Patent, Produce and Prosper	ಈ ದೇಶದಲ್ಲಿ ಬೆಳೆಯುತ್ತಿರುವ ಯುವ ವಿಜ್ಞಾನಿಗಳಿಗೆ ನನ್ನ ಧ್ಯೇಯವಾಕ್ಯವೆಂದರೆ -ಆವಿಷ್ಕರಿಸು, ಪೇಟೆಂಟ್ ಮಾಡಿಸು , ಉತ್ಪಾದಿಸು ಮತ್ತು ಪ್ರಗತಿ ಕಾಣು .
These four steps will lead our country towards faster development	ಈ ನಾಲ್ಕು ಹಂತಗಳು ನಮ್ಮ ದೇಶವನ್ನು ವೇಗವಾಗಿ ಅಭಿವೃದ್ಧಿಯತ್ತ ಕೊಂಡೊಯ್ಯುತ್ತವೆ.
Innovation for the people and by the people is the direction of our New India.	ಜನರಿಂದ ಮತ್ತು ಜನರಿಗಾಗಿ ಆವಿಷ್ಕಾರ ಎಂಬುದು ನಮ್ಮನವ ಭಾರತ ದ ಗುರಿಯಾಗಿದೆ.
We have to encourage and strengthen such changes.	ಅಂತಹ ಬದಲಾವಣೆಗಳನ್ನು ನಾವು ಪ್ರೋತ್ಸಾಹಿಸಬೇಕು ಮತ್ತು ಬಲಪಡಿಸಬೇಕು.
Rural development has been felt and experienced by the common man in the last 5 years	ಗ್ರಾಮೀಣಾಭಿವೃದ್ಧಿಯನ್ನು ಕಳೆದ 5 ವರ್ಷಗಳಲ್ಲಿ ಸಾಮಾನ್ಯ ಜನರು ಅನುಭವಿಸಿದ್ದಾರೆ.
Just yesterday, our government had set a record by transferring the money of PM KisanSammanNidhi to 6 crore farmers of the country at one go	ನಿನ್ನೆಯಷ್ಟೇ ನಮ್ಮ ಸರ್ಕಾರ ಪಿಎಂ ಕಿಸಾನ್ ಸಮ್ಮಾನ್ ನಿಧಿಯ ಹಣವನ್ನು ದೇಶದ 6 ಕೋಟಿ ರೈತರಿಗೆ ವರ್ಗಾಯಿಸುವ ಮೂಲಕ ದಾಖಲೆ ನಿರ್ಮಿಸಿದೆ.
It became possible with the help of Aadhaar enabled technology.	ಆಧಾರ್ ಆಧಾರಿತ ತಂತ್ರಜ್ಞಾನದ ಸಹಾಯದಿಂದ.
It is this technology that enabled the government to identify 8 crore poor sisters whose lives were being affected by the smoke of fuel wood	ಈ ತಂತ್ರಜ್ಞಾನದಿಂದಾಗಿ ಹೊಗೆಯಿಂದ ಕಷ್ಟ ಅನುಭವಿಸುತ್ತಿದ್ದ 8 ಕೋಟಿ ಬಡ ಸಹೋದರಿಯರನ್ನು ಗುರುತಿಸಲು ಸರ್ಕಾರಕ್ಕೆ ಸಾಧ್ಯವಾಯಿತು.
With the use of Geo Tagging and Data Science, now the speed of the projects has increased	ಜಿಯೋ ಟ್ಯಾಗಿಂಗ್ ಮತ್ತು ಡಾಟಾ ಸೈನ್ಸ್ ಬಳಕೆಯಿಂದ ಈಗ ಯೋಜನೆಗಳ ವೇಗ ಹೆಚ್ಚಾಗಿದೆ.
Digitalisation, E-commerce, internet banking and mobile banking services are assisting rural populations significantly	ಡಿಜಿಟಲೀಕರಣ, ಇ-ಕಾಮರ್ಸ್, ಇಂಟರ್ನೆಟ್ ಬ್ಯಾಂಕಿಂಗ್ ಮತ್ತು ಮೊಬೈಲ್ ಬ್ಯಾಂಕಿಂಗ್ ಸೇವೆಗಳು ಗ್ರಾಮೀಣ ಜನಸಂಖ್ಯೆಗೆ ಗಮನಾರ್ಹ ನೆರವು ಕಲ್ಪಿಸಿವೆ.
Today, farmers are getting the required information about the weather and forecasts easily through many e-governance initiatives.	ಇಂದು ರೈತರು ಹವಾಮಾನ ಮತ್ತು ಮುನ್ಸೂಚನೆಗಳ ಬಗ್ಗೆ ಅಗತ್ಯವಾದ ಮಾಹಿತಿಯನ್ನು ತಮ್ಮ ಬೆರಳ ತುದಿಯಲ್ಲಿಯೇ ಅನೇಕ ಇ-ಆಡಳಿತ ಉಪಕ್ರಮಗಳ ಮೂಲಕ ಪಡೆಯುತ್ತಿದ್ದಾರೆ.
We have to broaden the usefulness of technology in the development of India, especially in rural development	ಭಾರತದ ಅಭಿವೃದ್ಧಿಯಲ್ಲಿ, ವಿಶೇಷವಾಗಿ ಗ್ರಾಮೀಣಾಭಿವೃದ್ಧಿಯಲ್ಲಿ ತಂತ್ರಜ್ಞಾನದ ಬಳಕೆಯನ್ನು ನಾವು ವಿಸ್ತರಿಸಬೇಕಾಗಿದೆ.
The coming decade is going to be a decisive time for science and technology based governance in India	ಮುಂಬರುವ ದಶಕವು ಭಾರತದಲ್ಲಿ ವಿಜ್ಞಾನ ಮತ್ತು ತಂತ್ರಜ್ಞಾನ ಆಧಾರಿತ ಆಡಳಿತಕ್ಕೆ ನಿರ್ಣಾಯಕ ಸಮಯವಾಗಲಿದೆ.
It will directly benefit the village and the rural economy	ಇದರ ನೇರ ಲಾಭ ಗ್ರಾಮಕ್ಕೆ, ಗ್ರಾಮೀಣ ಆರ್ಥಿಕತೆಗೆ ಆಗಲಿದೆ.
The strength behind this campaign is also technology	ಈ ಅಭಿಯಾನದ ಶಕ್ತಿ ಕೂಡ ತಂತ್ರಜ್ಞಾನವೇ ಆಗಿದೆ.
In a way, Water Governance is a new frontier for you	ಒಂದು ರೀತಿಯಲ್ಲಿ, ನೀರಿನ ಆಡಳಿತವು ನಿಮಗೆ ಹೊಸ ಗಡಿಯಾಗಿದೆ.
The most important thing is that technical solutions are imperative to protect our farmers from losses in the supply chain.	ಅತ್ಯಂತ ಮುಖ್ಯವಾದ ವಿಷಯವೆಂದರೆ ಸರಬರಾಜು ಸರಪಳಿಯಲ್ಲಿ ನಮ್ಮ ರೈತರ ನಷ್ಟವನ್ನು ರಕ್ಷಿಸಲು ತಾಂತ್ರಿಕ ಪರಿಹಾರಗಳು ಬಹಳ ಮುಖ್ಯ.
Another important link in the economy of the village is our Micro, Small and Medium Enterprises i.e	ಗ್ರಾಮೀಣ ಆರ್ಥಿಕತೆಯ ಮತ್ತೊಂದು ಪ್ರಮುಖ ಕೊಂಡಿಯೆಂದರೆ ನಮ್ಮ ಸಣ್ಣ ಮತ್ತು ಮಧ್ಯಮ ಪ್ರಮಾಣದ ಉದ್ಯಮ ಅಂದರೆ ಎಂಎಸ್‌ಎಂಇ.
Now consider the use of single-use plastic	ಈಗ ಏಕ ಬಳಕೆ ಪ್ಲಾಸ್ಟಿಕ್ ಬಳಕೆಯನ್ನು ತೆಗೆದುಕೊಳ್ಳಿ.
We are trying to reduce crude oil imports by at least 10 per cent by the year 2022	2022 ರ ವೇಳೆಗೆ ಕಚ್ಚಾ ತೈಲ ಆಮದನ್ನು ಕನಿಷ್ಠ 10 ಪ್ರತಿಶತದಷ್ಟು ಕಡಿಮೆ ಮಾಡುವುದು ನಮ್ಮ ಪ್ರಯತ್ನ.
Hence, there is a lot of potential for Start-Ups in the bio-fuel ethanol manufacturing sector.	ಆದ್ದರಿಂದ, ಎಥೆನಾಲ್ ಉತ್ಪಾದನಾ ವಲಯದಲ್ಲಿ ಸ್ಟಾರ್ಟ್ ಅಪ್‌ಗಳಿಗೆ ಸಾಕಷ್ಟು ಅವಕಾಶವಿದೆ.
Remember, your contribution will play a huge role in making India a $ 5 trillion economy.	ನೆನಪಿಡಿ, ಭಾರತವನ್ನು 5 ಟ್ರಿಲಿಯನ್ ಆರ್ಥಿಕತೆಯನ್ನಾಗಿ ಮಾಡುವಲ್ಲಿ ನಿಮ್ಮ ಕೊಡುಗೆ ದೊಡ್ಡ ಪಾತ್ರ ವಹಿಸುತ್ತದೆ.
This will save the environment and will also develop our small scale industries.	ಇದು ಪರಿಸರವನ್ನು ಉಳಿಸುತ್ತದೆ ಮತ್ತು ನಮ್ಮ ಸಣ್ಣ ಕೈಗಾರಿಕೆಗಳನ್ನು ಸಹ ಅಭಿವೃದ್ಧಿಪಡಿಸುತ್ತದೆ.
Can we find farmer-centric solutions to the problem of stalk burning for instance?	ಉದಾಹರಣೆಗೆ ಕಾಂಡವನ್ನು ಸುಡುವ ಸಮಸ್ಯೆಗೆ ನಾವು ರೈತ-ಕೇಂದ್ರಿತ ಪರಿಹಾರಗಳನ್ನು ಕಂಡುಹಿಡಿಯಬಹುದೇ?
Can we also redesign our brick kilns for reduced emissions and greater energy efficiency?	ಕಡಿಮೆಯಾದ ಹೊರಸೂಸುವಿಕೆ ಮತ್ತು ಹೆಚ್ಚಿನ ಶಕ್ತಿಯ ದಕ್ಷತೆಗಾಗಿ ನಾವು ನಮ್ಮ ಇಟ್ಟಿಗೆ ಗೂಡುಗಳನ್ನು ಮರುವಿನ್ಯಾಸಗೊಳಿಸಬಹುದೇ?
How do we prevent effluents and discharge from industries from ruining our soil and our groundwater tables for years to come?	ಮುಂದಿನ ವರ್ಷಗಳಲ್ಲಿ ನಮ್ಮ ಮಣ್ಣು ಮತ್ತು ನಮ್ಮ ಅಂತರ್ಜಲ ಮಟ್ಟಗಳನ್ನು ಹಾಳು ಮಾಡದಂತೆ ಕೈಗಾರಿಕೆಗಳಿಂದ ಹೊರಸೂಸುವಿಕೆಯನ್ನು ನಾವು ಹೇಗೆ ತಡೆಯಬೇಕು?
Our vision should be to protect people from the threats of dangerous communicable diseases like Nipah, Ebola, etc	ನಮ್ಮ ದೃಷ್ಟಿಯು ನಿಫಾ, ಎಬೋಲಾ ಮುಂತಾದ ಅಪಾಯಕಾರಿ ಸಾಂಕ್ರಾಮಿಕ ರೋಗಗಳಿಂದ ಜನರನ್ನು ರಕ್ಷಿಸುವುದಾಗಿರಬೇಕು.
Globally, India is the leader in the supply of vaccines	ಜಾಗತಿಕವಾಗಿ, ಲಸಿಕೆಗಳ ಪೂರೈಕೆಯಲ್ಲಿ ಭಾರತ ಮುಂದಿದೆ.
We aim to develop India as a world-class, US$100 billion Bio-manufacturing hub by 2024	2024 ರ ವೇಳೆಗೆ ಭಾರತವನ್ನು ವಿಶ್ವ ದರ್ಜೆಯ, 100 ಬಿಲಿಯನ್ ಡಾಲರ್ ಜೈವಿಕ ಉತ್ಪಾದನಾ ಕೇಂದ್ರವಾಗಿ ಅಭಿವೃದ್ಧಿಪಡಿಸುವ ಗುರಿ ಹೊಂದಿದ್ದೇವೆ.
This will happen with right policy initiatives and support to innovative research, human resource development and entrepreneurial ecosystem.	ಇದು ಸೂಕ್ತ ನೀತಿ ಉಪಕ್ರಮಗಳು ಮತ್ತು ನವೀನ ಸಂಶೋಧನೆ, ಮಾನವ ಸಂಪನ್ಮೂಲ ಅಭಿವೃದ್ಧಿ ಮತ್ತು ಉದ್ಯಮಶೀಲ ವ್ಯವಸ್ಥೆಯ ಬೆಂಬಲದೊಂದಿಗೆ ಸಾದ್ಯವಾಗುತ್ತದೆ.
India must also develop a long term roadmap for sustainable and environment friendly transportation and energy storage options	ಸುಸ್ಥಿರ ಮತ್ತು ಪರಿಸರ ಸ್ನೇಹಿ ಸಾರಿಗೆ ಮತ್ತು ಇಂಧನ ಸಂಗ್ರಹ ಆಯ್ಕೆಗಳಿಗಾಗಿ ಭಾರತವು ದೀರ್ಘಾವಧಿಯ ಮಾರ್ಗಸೂಚಿಯನ್ನು ಅಭಿವೃದ್ಧಿಪಡಿಸಬೇಕು.
These require developing new battery types which are based on earth abundant, environmentally benign materials which are not monopolistic, are affordable on 100s of giga watt scales, and suitable for tropical climates.	ಇವುಗಳಿಗೆ ಭೂಮಿಯ ಸಮೃದ್ಧಿಯನ್ನು ಆಧರಿಸಿ, ಪರಿಸರಕ್ಕೆ ಹಾನಿಕರವಲ್ಲದ , 100 ರ ಗಿಗಾ ವ್ಯಾಟ್ ಮಾಪಕಗಳಲ್ಲಿ ಕೈಗೆಟುಕುವ ಮತ್ತು ಉಷ್ಣವಲಯದ ಹವಾಮಾನಕ್ಕೆ ಸೂಕ್ತವಾಗುವ ಹೊಸ ಬ್ಯಾಟರಿ ಪ್ರಕಾರಗಳನ್ನು ಅಭಿವೃದ್ಧಿಪಡಿಸುವ ಅಗತ್ಯವಿರುತ್ತದೆ.
This is evident from large reduction in casualties	ಸಾವು ನೋವುಗಳ ಸಂಖ್ಯೆಯಲ್ಲಿನ ಕಡಿತದಿಂದ ಇದು ಸ್ಪಷ್ಟವಾಗಿದೆ.
Our successes in space exploration should now be mirrored in the new frontier of the deep sea	ಬಾಹ್ಯಾಕಾಶ ಪರಿಶೋಧನೆಯಲ್ಲಿನ ನಮ್ಮ ಯಶಸ್ಸನ್ನು ಈಗ ಆಳ ಸಮುದ್ರದ ಹೊಸ ಗಡಿಯಲ್ಲಿ ಪ್ರತಿಬಿಂಬಿಸಬೇಕು.
We need to explore, map and responsibly harness the vast oceanic resources of water, energy, food and minerals	ನೀರು, ಇಂಧನ, ಆಹಾರ ಮತ್ತು ಖನಿಜಗಳ ಅಪಾರ ಸಾಗರ ಸಂಪನ್ಮೂಲಗಳನ್ನು ನಾವು ಅನ್ವೇಷಿಸಬೇಕು ಮತ್ತು ಜವಾಬ್ದಾರಿಯುತವಾಗಿ ಬಳಸಿಕೊಳ್ಳಬೇಕು.
This requires developing deep strengths in manned submersibles, deep sea mining systems and autonomous underwater vehicles	ಇದಕ್ಕೆ ಮಾನವಸಹಿತ ಸಬ್‌ಮರ್ಸಿಬಲ್‌ಗಳು, ಆಳ ಸಮುದ್ರ ಗಣಿಗಾರಿಕೆ ವ್ಯವಸ್ಥೆಗಳು ಮತ್ತು ಸ್ವಾಯತ್ತ ನೀರೊಳಗಿನ ವಾಹನಗಳನ್ನು ಅಭಿವೃದ್ಧಿಪಡಿಸುವ ಅಗತ್ಯವಿದೆ.
This, I hope will be made possible by a Deep Ocean Mission being formulated by the Ministry of Earth Sciences.	ಭೂ ವಿಜ್ಞಾನ ಸಚಿವಾಲಯವು ರೂಪಿಸಿರುವ ‘ಡೀಪ್ ಓಷನ್ ಮಿಷನ್’ ಮೂಲಕ ಇದು ಸಾಧ್ಯವಾಗಲಿದೆ ಎಂದು ನಾನು ಭಾವಿಸುತ್ತೇನೆ.
Can we build a Science in Motion?	ನಾವು ವಿಜ್ಞಾನದಲ್ಲಿ ಚಲನೆಯನ್ನು ನಿರ್ಮಿಸಬಹುದೇ?
Imagine the enormous impact of a full translation of our scientific potential into an unprecedented socio-economic development through relevant technologies, innovations, startups and industry	ಸಂಬಂಧಿತ ತಂತ್ರಜ್ಞಾನಗಳು, ಆವಿಷ್ಕಾರಗಳು, ಉದ್ಯಮಗಳು ಮತ್ತು ಉದ್ಯಮದ ಮೂಲಕ ನಮ್ಮ ವೈಜ್ಞಾನಿಕ ಸಾಮರ್ಥ್ಯದ ಅಭೂತಪೂರ್ವ ಸಾಮಾಜಿಕ-ಆರ್ಥಿಕ ಅಭಿವೃದ್ಧಿಯ ಅಗಾಧ ಪ್ರಭಾವವನ್ನು ಕಲ್ಪಿಸಿಕೊಳ್ಳಿ.
Can we have this high pressure steam drive a high speed engine of Science & Technology to navigate and connect the new India of opportunities?	ನವ ಭಾರತದ ಅವಕಾಶಗಳನ್ನು ಹುಡುಕಲು ಮತ್ತು ಸಂಪರ್ಕಿಸಲು ವಿಜ್ಞಾನ ಮತ್ತು ತಂತ್ರಜ್ಞಾನದ ವೇಗದ ಎಂಜಿನ್ ಅನ್ನು ನಾವು ಹೊಂದಬಹುದೇ?
Technology is the bridge between the government and the common man	ತಂತ್ರಜ್ಞಾನವು ಸರ್ಕಾರ ಮತ್ತು ಜನ ಸಾಮಾನ್ಯರ ನಡುವಿನ ಸೇತುವೆಯಾಗಿದೆ.
Once again, Happy New Year to all of you, the entire scientific community and your family	ಮತ್ತೊಮ್ಮೆ, ನಿಮ್ಮೆಲ್ಲರಿಗೂ, ಇಡೀ ವೈಜ್ಞಾನಿಕ ಸಮುದಾಯಕ್ಕೆ ಮತ್ತು ನಿಮ್ಮ ಕುಟುಂಬಕ್ಕೆ ಹೊಸ ವರ್ಷದ ಶುಭಾಶಯಗಳು.
Prime Minister inaugurates 107th Indian Science Congress	ಪ್ರಧಾನಿಯವರಿಂದ 107 ನೇ ಭಾರತೀಯ ವಿಜ್ಞಾನ ಕಾಂಗ್ರೆಸ್ ಉದ್ಘಾಟನೆ
The Prime Minister, Shri Narendra Modi inaugurated the 107th Indian Science Congress (ISC) today at University of Agricultural Sciences, Bengaluru.	ಪ್ರಧಾನಿ ಶ್ರೀ ನರೇಂದ್ರ ಮೋದಿ ಅವರು ಬೆಂಗಳೂರಿನ ಕೃಷಿ ವಿಜ್ಞಾನ ವಿಶ್ವವಿದ್ಯಾಲಯದಲ್ಲಿ 107 ನೇ ಭಾರತೀಯ ವಿಜ್ಞಾನ ಕಾಂಗ್ರೆಸ್ (ಐಎಸ್‌ಸಿ) ಉದ್ಘಾಟಿಸಿದರು.
Delivering the inaugural address, the Prime Minister said, The growth story of India depends on its achievements in the Science & Technology sector	ಉದ್ಘಾಟನಾ ಭಾಷಣ ಮಾಡಿದ ಪ್ರಧಾನಿಯವರು, “ಭಾರತದ ಪ್ರಗತಿಯ ಕಥೆ ವಿಜ್ಞಾನ ಮತ್ತು ತಂತ್ರಜ್ಞಾನ ಕ್ಷೇತ್ರದಲ್ಲಿ ಸಾಧಿಸಿದ ಸಾಧನೆಗಳ ಮೇಲೆ ಅವಲಂಬಿತವಾಗಿದೆ.
There is a need to revolutionise the landscape of Indian Science Technology and Innovation.	ಭಾರತೀಯ ವಿಜ್ಞಾನ ತಂತ್ರಜ್ಞಾನ ಮತ್ತು ಆವಿಷ್ಕಾರದ ಕ್ಷೇತ್ರದಲ್ಲಿ ಕ್ರಾಂತಿಯುಂಟುಮಾಡುವ ಅವಶ್ಯಕತೆಯಿದೆ.
My motto for the young scientists bourgeoning in this country has beenInnovate, Patent, Produce and Prosper	ದೇಶದಲ್ಲಿನ ಯುವ ವಿಜ್ಞಾನಿಗಳಿಗೆ ನನ್ನ ಧ್ಯೇಯವಾಕ್ಯವೆಂದರೆ -ಆವಿಷ್ಕರಿಸು, ಪೇಟೆಂಟ್ ಮಾಡಿಸು, ಉತ್ಪಾದಿಸು ಮತ್ತು ಪ್ರಗತಿ ಕಾಣು .
These four steps will lead our country towards faster development	ಈ ನಾಲ್ಕು ಹಂತಗಳು ನಮ್ಮ ದೇಶವನ್ನು ತ್ವರಿತವಾಗಿ ಅಭಿವೃದ್ಧಿಯತ್ತ ಕೊಂಡೊಯ್ಯುತ್ತವೆ.
This made the common man now believe that he is not distantly separated from the Government	ಇದು ಈಗ ತಾವು ಸರ್ಕಾರದಿಂದ ದೂರವಿಲ್ಲ ಎಂದು ಜನ ಸಾಮಾನ್ಯರು ನಂಬುವಂತೆ ಮಾಡಿದೆ.
Now he can directly connect with the Government and make his voice heard	ಈಗ ಅವರು ನೇರವಾಗಿ ಸರ್ಕಾರದೊಂದಿಗೆ ಸಂಪರ್ಕ ಸಾಧಿಸಬಹುದು ಮತ್ತು ಅವರ ಮಾತನ್ನು ಕೇಳುವಂತೆ ಮಾಡಬಹುದು ” ಎಂದರು.
Prime Minister exhorted the young scientists to work in the field of rural development where there are several opportunities for cheaper and better innovations.	ಅಗ್ಗದ ಮತ್ತು ಉತ್ತಮ ಆವಿಷ್ಕಾರಗಳಿಗೆ ಹಲವಾರು ಅವಕಾಶಗಳಿರುವ ಗ್ರಾಮೀಣಾಭಿವೃದ್ಧಿ ಕ್ಷೇತ್ರದಲ್ಲಿ ಕೆಲಸ ಮಾಡುವಂತೆ ಯುವ ವಿಜ್ಞಾನಿಗಳಿಗೆ ಪ್ರಧಾನಿಯವರು ಕರೆ ಕೊಟ್ಟರು.
Referring to the theme of 107th ISC - Science and Technology: Rural Development, the Prime Minister said that it is only due to Science & Technology, that Government Programmes have reached the needy.	107 ನೇ ಭಾರತೀಯ ವಿಜ್ಞಾನ ಕಾಂಗ್ರೆಸ್ ನ ಧ್ಯೇಯವಾದ “ವಿಜ್ಞಾನ ಮತ್ತು ತಂತ್ರಜ್ಞಾನ: ಗ್ರಾಮೀಣಾಭಿವೃದ್ಧಿ”ಯನ್ನು ಉಲ್ಲೇಖಿಸಿದ ಪ್ರಧಾನಿಯವರು, ವಿಜ್ಞಾನ ಮತ್ತು ತಂತ್ರಜ್ಞಾನದ ಕಾರಣದಿಂದಾಗಿಯೇ, ಸರ್ಕಾರದ ಕಾರ್ಯಕ್ರಮಗಳು ಅಗತ್ಯವಿರುವವರನ್ನು ತಲುಪಿವೆ ಎಂದರು.
He highlighted that India now stands at 3rdposition globally, in the number of Peer-reviewed Science and Engineering Publications	ಉತ್ತಮ ವಿಮರ್ಶೆಯ ವಿಜ್ಞಾನ ಮತ್ತು ಎಂಜಿನಿಯರಿಂಗ್ ಪ್ರಕಟಣೆಗಳ ಸಂಖ್ಯೆಯಲ್ಲಿ ಭಾರತ ಈಗ ಜಾಗತಿಕವಾಗಿ 3 ನೇ ಸ್ಥಾನದಲ್ಲಿರುವ ಬಗ್ಗೆ ಅವರು ಪ್ರಸ್ತಾಪಿಸಿದರು.
I have been told that India has climbed to third position globally in the number of peer reviewed science and engineering publications	“ಉತ್ತಮ ವಿಮರ್ಶೆಯ ವಿಜ್ಞಾನ ಮತ್ತು ಎಂಜಿನಿಯರಿಂಗ್ ಪ್ರಕಟಣೆಗಳ ಸಂಖ್ಯೆಯಲ್ಲಿ ಭಾರತ ಜಾಗತಿಕವಾಗಿ ಮೂರನೇ ಸ್ಥಾನಕ್ಕೆ ಏರಿದೆ ಎಂದು ನನಗೆ ಹೇಳಿದ್ದಾರೆ.
He also mentioned about Improvement in Indias ranking at Innovation Index to 52	ನಾವೀನ್ಯತೆಯ ಸೂಚ್ಯಂಕದಲ್ಲಿ ಭಾರತದ ಶ್ರೇಯಾಂಕ 52 ಕ್ಕೆ ಹೆಚ್ಚಿರುವ ಬಗ್ಗೆಯೂ ಅವರು ಪ್ರಸ್ತಾಪಿಸಿದರು.
He highlighted that Government programmes have created more incubators in the last 5 years than in previous 50 years.	ಕಳೆದ 5 ವರ್ಷಗಳಲ್ಲಿ ಸರ್ಕಾರದ ಕಾರ್ಯಕ್ರಮಗಳ ಫಲವಾಗಿ ಹಿಂದಿನ 50 ವರ್ಷಗಳ ಅವಧಿಯಲ್ಲಿ ಸೃಷ್ಟಿಸಿದ ಇನ್ಕ್ಯುಬೇಟರ್‌ಗಳಿಗಿಂತ ಹೆಚ್ಚನ್ನು ಈಗ ಸೃಷ್ಟಿಸಲಾಗಿದೆ ಎಂದು ಅವರು ಹೇಳಿದರು.
Yesterday our Government was able to release to 6 crore beneficiaries the instalment under the PM-KISAN programme	“ನಿನ್ನೆ ನಮ್ಮ ಸರ್ಕಾರವು 6 ಕೋಟಿ ಫಲಾನುಭವಿಗಳಿಗೆ ಪಿಎಂ-ಕಿಸಾನ್ ಕಾರ್ಯಕ್ರಮದಡಿ ಕಂತು ಬಿಡುಗಡೆ ಮಾಡಿತು.
This was possible only due the Aadhaar enabled technology, he said	ಆಧಾರ್ ಆಧರಿತ ತಂತ್ರಜ್ಞಾನದಿಂದಾಗಿ ಮಾತ್ರ ಇದು ಸಾಧ್ಯವಾಯಿತು” ಎಂದು ಅವರು ಹೇಳಿದರು.
Prime Minister said, We are continuing our efforts to ensure the Ease of doing Science and effectively using information technology to reduce red tape.	“ನಾವು ‘ಸುಗಮ ವಿಜ್ಞಾನ ಬಳಕೆ’ ಯನ್ನು ಖಚಿತಪಡಿಸಿಕೊಳ್ಳಲು ಪ್ರಯತ್ನಗಳನ್ನು ಮುಂದುವರಿಸುತ್ತಿದ್ದೇವೆ ಮತ್ತು ಅಧಿಕಾರಶಾಹಿಯನ್ನು ಕಡಿಮೆ ಮಾಡಲು ಮಾಹಿತಿ ತಂತ್ರಜ್ಞಾನವನ್ನು ಪರಿಣಾಮಕಾರಿಯಾಗಿ ಬಳಸುತ್ತಿದ್ದೇವೆ”ಎಂದು ಪ್ರಧಾನ ಮಂತ್ರಿ ಹೇಳಿದರು.
He emphasized that Digitalisation, E Commerce, Internet Banking and Mobile Banking services are assisting rural population significantly	ಡಿಜಿಟಲೀಕರಣ, ಇ ವಾಣಿಜ್ಯ, ಇಂಟರ್ನೆಟ್ ಬ್ಯಾಂಕಿಂಗ್ ಮತ್ತು ಮೊಬೈಲ್ ಬ್ಯಾಂಕಿಂಗ್ ಸೇವೆಗಳು ಗ್ರಾಮೀಣ ಜನರಿಗೆ ಗಮನಾರ್ಹವಾಗಿ ಸಹಾಯ ಮಾಡುತ್ತಿವೆ ಎಂದು ಅವರು ಒತ್ತಿ ಹೇಳಿದರು.
He said Technology can be harnessed for several rural development initiatives, particularly in the area of cost effective Agriculture and Farm to Consumer supply chain network.	ಹಲವಾರು ಗ್ರಾಮೀಣಾಭಿವೃದ್ಧಿ ಉಪಕ್ರಮಗಳಿಗೆ ಅದರಲ್ಲೂ ವಿಶೇಷವಾಗಿ ವೆಚ್ಚದಾಯಕ ಕೃಷಿ ಮತ್ತು ಹೊಲದಿಂದ ಗ್ರಾಹಕನವರೆಗಿನ ಪೂರೈಕೆ ಸರಪಳಿ ಜಾಲದಲ್ಲಿ ತಂತ್ರಜ್ಞಾನವನ್ನು ಬಳಸಿಕೊಳ್ಳಬಹುದು ಎಂದರು.
He emphasized that Science and technology has a major role in contributing towards making India a $5 Trillion Economy.	ಭಾರತವನ್ನು 5 ಟ್ರಿಲಿಯನ್ ಡಾಲರ್ ಆರ್ಥಿಕತೆಯನ್ನಾಗಿ ಮಾಡುವಲ್ಲಿ ವಿಜ್ಞಾನ ಮತ್ತು ತಂತ್ರಜ್ಞಾನವು ಪ್ರಮುಖ ಪಾತ್ರ ವಹಿಸುತ್ತದೆ ಎಂದು ಪ್ರಧಾನಿ ಒತ್ತಿ ಹೇಳಿದರು.
Prime Minister Modi also launched the I-STEM Portal on the occasion.	ಈ ಸಂದರ್ಭದಲ್ಲಿ ಪ್ರಧಾನಿ ಮೋದಿಯವರು I-STEM ಪೋರ್ಟಲ್ ಗೆ ಚಾಲನೆ ನೀಡಿದರು.
Telephone Conversation between Prime Minister Shri Narendra Modi and the Prime Minister of Australia HMrott Morrison	ಪ್ರಧಾನಮಂತ್ರಿ ಶ್ರೀ ನರೇಂದ್ರ ಮೋದಿ ಆಸ್ಟ್ರೇಲಿಯಾದ ಪ್ರಧಾನಮಂತ್ರಿ ಗೌರವಾನ್ವಿತ ಸ್ಕಾಟ್ ಮಾರಿಸನ್ ಅವರೊಂದಿಗೆ ದೂರವಾಣಿ ಸಮಾಲೋಚನೆ
Call on Prime Minister by Mrarman Shanmugaratnam, Senior Minister and Coordinating Minister for Social Policies, Singapore	ಸಿಂಗಾಪೂರದ ಸಾಮಾಜಿಕ ನೀತಿಗಳ ಸಮನ್ವಯ ಸಚಿವರಾದ ಶ್ರೀ ಥರ್ಮನ್ ಷಣ್ಮುಗರತ್ನಂ ಅವರಿಂದ ಪ್ರಧಾನಿ ಭೇಟಿ
Mrarman Shanmugaratnam, Senior Minister and Coordinating Minister for Social Policies, Singapore called on Prime Minister Shri Narendra Modi today.	ಸಿಂಗಾಪೂರದ ಸಾಮಾಜಿಕ ನೀತಿಗಳ ಸಮನ್ವಯ ಸಚಿವರಾದ ಶ್ರೀ ಥರ್ಮನ್ ಷಣ್ಮುಗರತ್ನಂ ಅವರು ಪ್ರಧಾನಮಂತ್ರಿ ಶ್ರೀ ನರೇಂದ್ರ ಮೋದಿಯವರನ್ನು ಭೇಟಿ ಮಾಡಿದರು.
Prime Minister welcomed Mranmugaratnam to India and extended his warm wishes on the occasion of New Year to Mranmugaratnam and through him to Mre Hsien Loong, Prime Minister of Singapore.	ಪ್ರಧಾನಮಂತ್ರಿಗಳು ಶ್ರೀ ಷಣ್ಮುಗರತ್ನಂ ಅವರನ್ನು ಸ್ವಾಗತಿಸಿ ಹೊಸ ವರ್ಷದ ಶುಭಾಶಯ ಕೋರಿ, ಅವರ ಮೂಲಕ ಸಿಂಗಾಪೂರದ ಪ್ರಧಾನಿ ಶ್ರೀ ಲೀ ಸೇನ್ ಲೂಂಗ್ ಅವರಿಗೆ ಶುಭಾಶಯ ಕೋರಿದರು.
Mranmugaratnam lauded Prime Minister Shri Narendra Modis leadership in social transformation of India and in encouraging digital economy.	ಶ್ರೀ ಷಣ್ಮುಗರತ್ನಂ ಅವರು ಡಿಜಿಟಲ್ ಆರ್ಥಿಕತೆ ಮತ್ತು ಭಾರತದ ಸಾಮಾಜಿಕ ಪರಿವರ್ತನೆಗೆ ಪ್ರೋತ್ಸಾಹ ನೀಡುತ್ತಿರುವ ಮೋದಿಯವರ ನಾಯಕತ್ವವನ್ನು ಶ್ಲಾಘಿಸಿದರು.
Prime Minister also expressed his desire to strengthen further cooperation between India and Singapore in the areas of infrastructure, tourism, digital payment systems, innovation and governance.	ಮೂಲಭೂತ ಸೌಕರ್ಯಗಳು, ಪ್ರವಾಸೋದ್ಯಮ, ಡಿಜಿಟಲ್ ಪಾವತಿಯ ವ್ಯವಸ್ಥೆ, ಆವಿಷ್ಕಾರ ಮತ್ತು ಆಡಳಿತ ಕ್ಷೇತ್ರಗಳಲ್ಲಿ ಭಾರತ ಮತ್ತು ಸಿಂಗಾಪೂರ್ ಮಧ್ಯೆ ಸಹಕಾರ ವೃದ್ಧಿಯ ಇಚ್ಛೆಯನ್ನು ಸಹ ಪ್ರಧಾನಮಂತ್ರಿಯವರು ವ್ಯಕ್ತಪಡಿಸಿದರು.
PM attends the centenary celebrations of Kirloskar Brothers Ltd.	ಕಿರ್ಲೊಸ್ಕರ್ ಬ್ರದರ್ಸ್ ಲಿಮಿಟೆಡ್ ನ ಶತಮಾನೋತ್ಸವ ಸಮಾರಂಭದಲ್ಲಿ ಪ್ರಧಾನ ಮಂತ್ರಿ
Indias entrepreneur is impatient for the development of the country and to expand his capabilities and successes.	ದೇಶದ ಅಭಿವೃದ್ಧಿ ಮತ್ತು ತನ್ನ ಸಾಮರ್ಥ್ಯ ಮತ್ತು ಯಶಸ್ಸು ವೃದ್ಧಿಗೆ ಭಾರತೀಯ ಉದ್ಯಮಿಗಳು ಹಾತೊರೆಯುತ್ತಿದ್ದಾರೆ ಎಂದರು.
PM stated that the true power of the people of the country can come to the fore only when the government stands not as a hindrance to India, Indian and Industries, but as their partner.	ಭಾರತೀಯರಿಗೆ ಮತ್ತು ಉದ್ಯಮಗಳಿಗೆ ಸರ್ಕಾರ ತಡೆಗೋಡೆಯಾಗಿ ನಿಲ್ಲದೆ ಪಾಲುದಾರನಂತೆ ವರ್ತಿಸಿದಲ್ಲಿ ಮಾತ್ರ ದೇಶದ ಜನತೆಯ ನಿಜವಾದ ಶಕ್ತಿ ಕಾರ್ಯರೂಪಕ್ಕೆ ಬರಲಿದೆ ಎಂದು ಪ್ರಧಾನ ಮಂತ್ರಿಗಳು ತಮ್ಮ ಅಭಿಪ್ರಾಯ ವ್ಯಕ್ತಪಡಿಸಿದರು.
This has given the country the courage to set big goals and achieve them on time.	ಇದು ದೇಶ ಬೃಹತ್ ಗುರಿಗಳನ್ನು ಹೊಂದುವ ಮತ್ತು ಸಮಯಕ್ಕೆ ಸರಿಯಾಗಿ ಅವುಗಳನ್ನು ಪೂರೈಸಿಕೊಳ್ಳುವ ಆತ್ಮಸ್ಥೈರ್ಯ ನೀಡಿದೆ.
Similarly success stories of Make in India campaign are the strength of our industry	“ಮೇಕ್ ಇನ್ ಇಂಡಿಯಾ ಅಭಿಯನದ ಯಶೋಗಾಥೆಗಳು ನಮ್ಮ ಉದ್ಯಮಕ್ಕೆ ಪುಷ್ಠಿ ನೀಡುವಂಥವಾಗಿವೆ.
I want success stories from every field of Indian industry, the PM added.	ಭಾರತದ ಪ್ರತಿ ಉದ್ಯಮ ಕ್ಷೇತ್ರದಿಂದಲೂ ನಾನು ಯಶೋಗಾಥೆಗಳನ್ನು ಕೇಳಬಯಸುತ್ತೇನೆ”, ಎಂದು ಪ್ರಧಾನಮಂತ್ರಿ ಶ್ರೀ ನರೇಂದ್ರ ಮೋದಿಯವರು ತಿಳಿಸಿದರು.
PM talks to the President of United States, Donald Trump	ಅಮೆರಿಕ ಅಧ್ಯಕ್ಷ ಶ್ರೀ ಡೊನಾಲ್ಡ್ ಟ್ರಂಪ್ ಜೊತೆ ಪ್ರಧಾನಮಂತ್ರಿ ಮಾತುಕತೆ
Prime Minister Shri Narendra Modi spoke with His Excellency Mr Donald Trump, President of the United States to convey New Year greetings.	ಅಮೆರಿಕ ಅಧ್ಯಕ್ಷ ಘನತೆವೆತ್ತ ಶ್ರೀ ಡೊನಾಲ್ಡ್ ಟ್ರಂಪ್ ಅವರಿಗೆ ಪ್ರಧಾನಮಂತ್ರಿ ಶ್ರೀ ನರೇಂದ್ರ ಮೋದಿ ಅವರು ಹೊಸ ವರ್ಷದ ಶುಭಾಶಯಗಳನ್ನು ಕೋರಿದರು.
The Prime Minister wished President Trump, his family and the people of the United States good health, prosperity and success in the New Year.	ಪ್ರಧಾನಮಂತ್ರಿ ಅವರು ಅಧ್ಯಕ್ಷ ಶ್ರೀ ಟ್ರಂಪ್, ಅವರ ಕುಟುಂಬ ಮತ್ತು ಯು ಎಸ್ ಪ್ರಜೆಗಳಿಗೆ ಉತ್ತಮ ಆರೋಗ್ಯ, ಸಮೃದ್ಧಿ ಮತ್ತು ಯಶಸ್ಸು ದೊರಕಲಿ ಎಂದು ಹಾರೈಸಿದರು
The Prime Minister highlighted the significant progress made in deepening the Strategic Partnership between the two countries in the previous year and expressed his desire to continue to work with President Trump for enhancing cooperation in all areas of mutual interest.	ಹಿಂದಿನ ವರ್ಷದಲ್ಲಿ ಉಭಯ ದೇಶಗಳ ನಡುವಿನ ವ್ಯೂಹಾತ್ಮಕ ಕಾರ್ಯತಂತ್ರದ ಸಹಭಾಗಿತ್ವಗಳಲ್ಲಿ ಮಹತ್ವದ ಪ್ರಗತಿ ಸಾಧನೆಯನ್ನು ಪ್ರಧಾನಮಂತ್ರಿ ಈ ಸಂದರ್ಭದಲ್ಲಿ ನೆನಪಿಸಿದರು ಮತ್ತು ಪರಸ್ಪರ ಹಿತಾಸಕ್ತಿಯ ಎಲ್ಲ ಕ್ಷೇತ್ರಗಳಲ್ಲಿ ಸಹಕಾರಗಳನ್ನು ಹೆಚ್ಚಿಸಲು ಅಧ್ಯಕ್ಷ ಶ್ರೀ ಟ್ರಂಪ್ ಅವರೊಂದಿಗೆ ಕೆಲಸ ಮುಂದುವರಿಸುವ ಆಶಯ ವ್ಯಕ್ತಪಡಿಸಿದರು.
President Trump wished the people of India prosperity and progress in the New Year	ಹೊಸ ವರ್ಷದ ಸಂದರ್ಭದಲ್ಲಿ ಅಧ್ಯಕ್ಷ ಶ್ರೀ ಟ್ರಂಪ್ ಅವರು ಭಾರತದ ಜನರಿಗೆ ಸಮೃದ್ಧಿ ಮತ್ತು ಪ್ರಗತಿಯ ಶುಭ ಹಾರೈಸಿದರು.
He expressed satisfaction at the achievements in the relationship in the last few years and reiterated his readiness for further deepening bilateral cooperation.	ಕಳೆದ ಕೆಲವು ವರ್ಷಗಳಲ್ಲಿ ಈ ಎರಡೂ ದೇಶಗಳ ಪರಸ್ಪರ ಸಂಬಂಧಗಳಲ್ಲಿ ಅಭಿವೃದ್ಧಿ ಬಗ್ಗೆ ಅವರು ತೃಪ್ತಿ ವ್ಯಕ್ತಪಡಿಸಿದ ಅವರು ದ್ವಿಪಕ್ಷೀಯ ಸಹಕಾರವನ್ನು ಮುಂದಿನ ದಿನಗಳಲ್ಲಿ ಇನ್ನಷ್ಟೂ ಸದೃಢವಾಗಿಸಲು ಸಿದ್ಧ ಎಂದು ಪುನರುಚ್ಚರಿಸಿದರು.
Vice President stresses the need to make India a global hub of higher learning	ಭಾರತವನ್ನು ಉನ್ನತ ಶಿಕ್ಷಣದ ಜಾಗತಿಕ ಕೇಂದ್ರವಾಗಿ ಪರಿವರ್ತಿಸುವ ಅಗತ್ಯವಿದೆ ಎಂದು ಉಪ ರಾಷ್ಟ್ರಪತಿ ಪ್ರತಿಪಾದನೆ
Expressing concerns that none of the Indian Universities figured in the top 100 global rankings, Shri Naidu asked institutions such as NAAC and UGC to take steps to address the shortcomings by revisiting the education system and revamping the curriculum in tune with 21st century requirements	ಜಾಗತಿಕ ಶ್ರೇಯಾಂಕದಲ್ಲಿ ಪ್ರಥಮ 100 ವಿಶ್ವವಿದ್ಯಾಲಯಗಳ ಪಟ್ಟಿಯಲ್ಲಿ ಒಂದೇ ಒಂದು ಭಾರತೀಯ ವಿಶ್ವವಿದ್ಯಾಲಯವೂ ಇಲ್ಲದಿರುವ ಬಗ್ಗೆ ಕಳವಳ ವ್ಯಕ್ತಪಡಿಸಿದ ಉಪರಾಷ್ಟ್ರಪತಿ ಶ್ರೀ ನಾಯ್ಡು, ನ್ಯಾಕ್ ಮತ್ತು ಯುಜಿಸಿ ಯಂಥ ಸಂಸ್ಥೆಗಳು ಶಿಕ್ಷಣ ವ್ಯವಸ್ಥೆಯನ್ನು ಪುನಶ್ಚೇತನಗೊಳಿಸಲು 21ನೇ ಶತಮಾನದ ಅವಶ್ಯಕತೆಗಳಿಗೆ ಅನುಗುಣವಾಗಿ ಪಠ್ಯಕ್ರಮವನ್ನು ಪರಿಷ್ಕರಿಸುವ ಮೂಲಕ ಈ ಕೊರತೆಯನ್ನು ಪರಿಹರಿಸಲು ಕ್ರಮ ಕೈಗೊಳ್ಳಬೇಕು ಎಂದು ಹೇಳಿದರು.
Speaking at the Silver Jubilee function of National Assessment and Accreditation Council (NAAC) in Bengaluru today, Shri Naidu expressed his concern over the recent disturbances on the campuses of a few Universities and called for maintaining peace.	ಬೆಂಗಳೂರಿನಲ್ಲಿಂದು ರಾಷ್ಟ್ರೀಯ ಮೌಲ್ಯಮಾಪನ ಮತ್ತು ಮಾನ್ಯತಾ ಮಂಡಳಿ (ನ್ಯಾಕ್)ಯ ರಜತ ಮಹೋತ್ಸವ ಸಮಾರಂಭದಲ್ಲಿ ಮಾತನಾಡಿದ ಅವರು, ಕೆಲವು ವಿಶ್ವವಿದ್ಯಾಲಯಗಳ ಆವರಣದಲ್ಲಿ ಇತ್ತೀಚೆಗೆ ನಡೆದ ಅಹಿತಕರ ಘಟನೆಗಳ ಬಗ್ಗೆ ಕಳವಳ ವ್ಯಕ್ತಪಡಿಸಿದರು ಮತ್ತು ಶಾಂತಿಸೌಹಾರ್ದತೆ ಕಾಪಾಡಲು ಮನವಿ ಮಾಡಿದರು.
He stressed that the academic endeavours and co-curricular initiatives must attain primacy in universities and not factionalism and divisive tendencies.	ಶೈಕ್ಷಣಿಕ ಪ್ರಯತ್ನಗಳು ಮತ್ತು ಪಠ್ಯೇತರ ಉಪಕ್ರಮಗಳು ವಿಶ್ವವಿದ್ಯಾಲಯಗಳಲ್ಲಿ ಪ್ರಾಮುಖ್ಯತೆಯನ್ನು ಪಡೆಯಬೇಕೇ ಹೊರತು ಬಣ ಮತ್ತು ವಿಭಜಕ ಪ್ರವೃತ್ತಿಗಳನ್ನಲ್ಲ ಎಂದು ಅವರು ಒತ್ತಿ ಹೇಳಿದರು.
The Vice President said that it was the duty of the education system to produce model global citizens who would contribute towards building a better world.	ಉತ್ತಮ ವಿಶ್ವ ನಿರ್ಮಾಣಕ್ಕೆ ಕೊಡುಗೆ ನೀಡಬಲ್ಲ, ಮಾದರಿ ಜಾಗತಿಕ ನಾಗರಿಕರನ್ನು ರೂಪಿಸುವುದು ಶಿಕ್ಷಣ ವ್ಯವಸ್ಥೆಯ ಕರ್ತವ್ಯ ಎಂದು ಉಪ ರಾಷ್ಟ್ರಪತಿಯವರು ಹೇಳಿದರು.
Pointing out that the students leaving the portals of the educational institutions must be enlightened citizens with social consciousness and responsibility towards the society, Shri Naidu stressed that Institutions must mould students into empathetic human beings with high integrity.	ಶಿಕ್ಷಣ ಸಂಸ್ಥೆಗಳಿಂದ ಹೊರಬರುವ ವಿದ್ಯಾರ್ಥಿಗಳು ಸಾಮಾಜಿಕ ಪ್ರಜ್ಞೆ ಮತ್ತು ಸಮಾಜದ ಬಗ್ಗೆ ಜವಾಬ್ದಾರಿಯನ್ನು ಹೊಂದುವಂತಹ ಅರಿವಿನ ನಾಗರಿಕರಾಗಬೇಕು ಎಂದ ಉಪ ರಾಷ್ಟ್ರಪತಿ ಶ್ರೀ ನಾಯ್ಡು, ಶಿಕ್ಷಣ ಸಂಸ್ಥೆಗಳು ವಿದ್ಯಾರ್ಥಿಗಳನ್ನು ಉನ್ನತ ಏಕತೆಯ ಉತ್ಸಾಹಿ ಮಾನವರನ್ನಾಗಿ ರೂಪಿಸಬೇಕು ಎಂದರು.
Stating that Mahatma Gandhi considered knowledge without character as a sin, the Vice President said that education which teaches, values, ethics and inculcates the spirit of voluntarism and compassion was the need of the hour	ಮಹಾತ್ಮಾ ಗಾಂಧಿ ಅವರು ನಡತೆ ರಹಿತವಾದ ಜ್ಞಾನ ಒಂದು ಶಾಪ ಎಂದು ಹೇಳಿದ್ದರು ಎಂದು ಉಲ್ಲೇಖಿಸಿದ ಉಪರಾಷ್ಟ್ರಪತಿಯವರು, ಮೌಲ್ಯಗಳು, ತತ್ವಗಳನ್ನು ಬೋಧಿಸುವ ಶಿಕ್ಷಣವು ಸ್ವಯಂ ಸ್ಫೂರ್ತಿ ಮತ್ತು ಸಹಾನುಭೂತಿಯನ್ನೂ ಮೂಡಿಸಬೇಕಾದ್ದು ಇಂದಿನ ಅಗತ್ಯವಾಗಿದೆ ಎಂದು ಪ್ರತಿಪಾದಿಸಿದರು.
He said that education system must also make the students aware of Indias glorious heritage, culture and history.	ಶಿಕ್ಷಣ ವ್ಯವಸ್ಥೆಯು ವಿದ್ಯಾರ್ಥಿಗಳಿಗೆ ಭಾರತದ ವೈಭವದ ಪರಂಪರೆ, ಸಂಸ್ಕೃತಿ ಹಾಗೂ ಇತಿಹಾಸವನ್ನೂ ತಿಳಿಸುವಂತಿರಬೇಕು ಎಂದರು.
Referring to Indias ancient centers of learning such as Nalanda, Vikramsila, Takshashila which earned global reputation, the Vice President called upon higher educational institutions to aspire to regain the past glory	ಭಾರತದ ಪುರಾತನ ಕಲಿಕಾ ಕೇಂದ್ರಗಳಾಗಿದ್ದ ನಳಂದಾ, ವಿಕ್ರಮಶಿಲಾ, ತಕ್ಷಶಿಲೆಗಳು ಜಾಗತಿಕ ಮನ್ನಣೆ ಪಡೆದಿದ್ದವು ಎಂದು ಉಲ್ಲೇಖಿಸಿದ ಉಪ ರಾಷ್ಟ್ರಪತಿಯವರು, ಗತ ವೈಭವವನ್ನು ಮರಳಿ ಪಡೆಯಲು ಶ್ರಮಿಸುವಂತೆ ಉನ್ನತ ಶಿಕ್ಷಣ ಸಂಸ್ಥೆಗಳಿಗೆ ಕರೆ ನೀಡಿದರು.
He urged upon all Educational institutions to transform into centers of excellence where students acquire knowledge, skills and attitude necessary for a successful, happy and accomplished life	ಎಲ್ಲ ಶಿಕ್ಷಣ ಸಂಸ್ಥೆಗಳೂ ಔನ್ನತ್ಯದ ಕೇಂದ್ರಗಳಾಗಿ ಪರಿವರ್ತನೆಯಾಗಬೇಕು ಎಂದು ಆಗ್ರಹಿಸಿದ ಅವರು, ಅಲ್ಲಿ ವಿದ್ಯಾರ್ಥಿಗಳು ಸಾರ್ಥಕ ಬದುಕು, ಯಶಸ್ಸು ಮತ್ತು ಸಂತಸಕ್ಕೆ ಅಗತ್ಯವಾದ ಜ್ಞಾನ, ಕೌಶಲ, ಅಗತ್ಯ ನಡೆವಳಿಕೆ ಕಲಿಯುವಂತಿರಬೇಕು ಎಂದರು.
NAAC was established in 1994 as an autonomous institution of the University Grants Commission (UGC) with its Head Quarters in Bengaluru	ವಿಶ್ವವಿದ್ಯಾಲಯಗಳ ಧನ ಸಹಾಯ ಆಯೋಗ (ಯುಜಿಸಿ)ದ ಸ್ವಾಯತ್ತ ಸಂಸ್ಥೆಯಾಗಿ 1994ರಲ್ಲಿ ಸ್ಥಾಪನೆಯಾದ ನ್ಯಾಕ್, ಬೆಂಗಳೂರಿನಲ್ಲಿ ತನ್ನ ಕೇಂದ್ರ ಕಚೇರಿಯನ್ನು ಹೊಂದಿದೆ.
NAAC evaluates the institutions for its conformance to the standards of quality in terms of educational processes and outcomes, curriculum coverage, teaching-learning processes, faculty, research, infrastructure, learning resources, organisation, governance, financial well-being and student services.	ಸಂಸ್ಥೆಗಳು ಒದಗಿಸುತ್ತಿರುವ ಶೈಕ್ಷಣಿಕ ಪ್ರಕ್ರಿಯೆಗಳು ಮತ್ತು ಅದರ ಫಲಶ್ರುತಿಗಳು, ಪಠ್ಯಕ್ರಮದ ವ್ಯಾಪ್ತಿ, ಬೋಧನೆ-ಕಲಿಕೆಯ ಪ್ರಕ್ರಿಯೆಗಳು, ಅಧ್ಯಾಪಕರು, ಸಂಶೋಧನೆ, ಮೂಲಸೌಕರ್ಯ, ಕಲಿಕಾ ಸಂಪನ್ಮೂಲಗಳು, ಸಂಘಟನೆ, ಆಡಳಿತ, ಆರ್ಥಿಕ ಕ್ಷಮತೆ ಮತ್ತು ವಿದ್ಯಾರ್ಥಿಗಳಿಗೆ ಒದಗಿಸಲಾದ ಸೇವೆಗಳು ಗುಣಮಟ್ಟದ ಮಾನದಂಡಗಳಿಗೆ ಅನುಗುಣವಾಗಿವೆಯೇ ಎಂಬುದನ್ನು ಖಾತ್ರಿಪಡಿಸಿಕೊಳ್ಳಲು ನ್ಯಾಕ್ ಮೌಲ್ಯಮಾಪನ ಮಾಡುತ್ತದೆ.
I have visited a number of NAAC accredited educational institutions after I have assumed the office of the Vice President of India	ನಾನು ಭಾರತದ ಉಪರಾಷ್ಟ್ರಪತಿಯಾಗಿ ಅಧಿಕಾರ ವಹಿಸಿಕೊಂಡ ಬಳಿಕ ನ್ಯಾಕ್ ನಿಂದ ಮಾನ್ಯತೆ ಪಡೆದಿರುವ ಹಲವು ಉನ್ನತ ಶಿಕ್ಷಣ ಸಂಸ್ಥೆಗಳಿಗೆ ಭೇಟಿ ನೀಡಿದ್ದೇನೆ.
In all these institutions, I saw great potential and an unwavering commitment to excellence when it comes to the quality of education they provide	ಈ ಎಲ್ಲ ಸಂಸ್ಥೆಗಳಲ್ಲಿ ಅವರು ಒದಗಿಸುವ ಗುಣಮಟ್ಟದ ಶಿಕ್ಷಣದಲ್ಲಿ ಔನ್ನತ್ಯ ಸಾಧಿಸುವುದಕ್ಕಾಗಿ ದೊಡ್ಡ ಕ್ಷಮತೆ ಮತ್ತು ಅದಮ್ಯ ಬದ್ಧತೆ ಹೊಂದಿರುವುದನ್ನು ನಾನು ಕಂಡಿದ್ದೇನೆ.
I must say that the accreditation framework developed by NAAC has gone a long way in augmenting the quality of higher education in India	ಭಾರತದಲ್ಲಿ ಉನ್ನತ ಶಿಕ್ಷಣದ ಗುಣಮಟ್ಟವನ್ನು ಹೆಚ್ಚಿಸುವಲ್ಲಿ ನ್ಯಾಕ್ ಅಭಿವೃದ್ಧಿಪಡಿಸಿದ ಮಾನ್ಯತೆಯ ಚೌಕಟ್ಟು ಬಹಳ ದೂರ ಸಾಗಿದೆ ಎಂದು ನಾನು ಹೇಳಲೇಬೇಕು.
Today, as we celebrate the many accomplishments of NAAC over the last 25 years, let me congratulate all those who have been associated with this organization for toiling hard to take it to its current lofty status	ನ್ಯಾಕ್ ನ ಕಳೆದ 25 ವರ್ಷಗಳ ಹಲವು ಸಾಧನೆಯನ್ನು ಇಂದು ನಾವು ಆಚರಿಸುವಾಗ, ಅದು ಇಂದು ಹೊಂದಿರುವ ಉನ್ನತ ಸ್ಥಾನಮಾನಕ್ಕೆ ಕೊಂಡೊಯ್ಯಲು ಈ ಸಂಸ್ಥೆಯೊಂದಿಗೆ ಸಂಬಂಧ ಹೊಂದಿ ಶ್ರಮಿಸಿರುವ ಎಲ್ಲರನ್ನೂ ನಾನು ಅಭಿನಂದಿಸುತ್ತೇನೆ.
My dear sisters and brothers,	ನನ್ನ ಪ್ರೀತಿಯ ಸಹೋದರ ಸಹೋದರಿಯರೇ,
India has one of the largest and most diverse education systems in the world	ಭಾರತ ವಿಶ್ವದಲ್ಲೇ ಒಂದು ದೊಡ್ಡ ಮತ್ತು ವೈವಿಧ್ಯಮಯ ಶಿಕ್ಷಣ ವ್ಯವಸ್ಥೆ ಹೊಂದಿರುವ ರಾಷ್ಟ್ರವಾಗಿದೆ.
India is undoubtedly a country to reckon with in the globe today	ಭಾರತವನ್ನು ಇಂದು ಜಗತ್ತೇ ಪರಿಗಣಿಸಿದೆ ಎಂಬುದರಲ್ಲಿ ಯಾವುದೇ ಅನುಮಾನವಿಲ್ಲ.
Its achievements are worthy of emulation and serve as a model for any developing nation	ಇದರ ಸಾಧನೆಗಳು ಅನುಕರಣಾರ್ಹವಾಗಿವೆ ಮತ್ತು ಯಾವುದೇ ಅಭಿವೃದ್ಧಿಶೀಲ ರಾಷ್ಟ್ರಗಳಿಗೆ ಮಾದರಿಯಾಗಿ ಕಾರ್ಯನಿರ್ವಹಿಸುತ್ತಿವೆ.
With the challenges that India had after her independence, she has continuously strived to achieve several crucial milestones, be it in the area of agriculture, industry, science and technology, space science, defense and many others	ಭಾರತವು ಸ್ವಾತಂತ್ರ್ಯ ಪಡೆದ ಬಳಿಕ ಎದುರಿಸಿದ ಸವಾಲುಗಳ ನಡುವೆಯೂ, ಹಲವು ಮೈಲುಗಲ್ಲಿನ ಸಾಧನೆ ಮಾಡಿದೆ, ಅದು ಕೃಷಿ ಕ್ಷೇತ್ರವೇ ಇರಲಿ, ಕೈಗಾರಿಕೆಯೇ ಇರಲಿ, ವಿಜ್ಞಾನ ತಂತ್ರಜ್ಞಾನವೇ ಇರಲಿ, ಬಾಹ್ಯಾಕಾಶ ವಿಜ್ಞಾನವೇ ಇರಲಿ ಅಥವಾ ಇನ್ನಾವುದೇ ಕ್ಷೇತ್ರವಿರಲಿ ನಿರಂತರವಾಗಿ ಶ್ರಮಿಸಿದೆ.
We have an incredible demographic dividend at our disposal, 65% of our population is below 35 years of age.	ನಮ್ಮಲ್ಲಿ ಅದ್ಭುತ ಮಾನವ ಸಂಪನ್ಮೂಲವಿದ್ದು, ಇದರಲ್ಲಿ ಶೇಕಡ 65ರಷ್ಟು ಮಂದಿ 35 ವರ್ಷ ವಯೋಮಾನದೊಳಗಿನವರು ಆಗಿರುವುದು ನಮಗೆ ದೊಡ್ಡ ಲಾಭಾಂಶವಾಗಿದೆ.
According to the report, titled World Economic League Table 2020, released by UK-based Centre for Economics and Business Research (CEBR), India has decisively overtaken both France and the UK to become the worlds fifth-largest economy in 2019	ಯು ಕೆ ಮೂಲದ ಆರ್ಥಿಕ ಮತ್ತು ವಾಣಿಜ್ಯ ಸಂಶೋಧನೆ ಕುರಿತ ಕೇಂದ್ರ (ಸಿಇಬಿಆರ್) ಬಿಡುಗಡೆ ಮಾಡಿರುವ ‘ವಿಶ್ವ ಆರ್ಥಿಕ ಸಂಘಟನೆ ಪಟ್ಟಿ 2020’ ಶೀರ್ಷಿಕೆಯ ವರದಿಯ ಪ್ರಕಾರ ಭಾರತವು 2019 ರಲ್ಲಿ ಫ್ರಾನ್ಸ್ ಮತ್ತು ಯು ಕೆ ಎರಡನ್ನೂ ಹಿಂದೆ ಹಾಕಿ ವಿಶ್ವದ ಐದನೇ ಅತಿದೊಡ್ಡ ಆರ್ಥಿಕತೆ ರಾಷ್ಟ್ರವಾಗಿದೆ.
It is expected to overtake Germany to become fourth largest in 2026 and Japan to become the third largest in 2034	2026 ರ ಹೊತ್ತಿಗೆ ಜರ್ಮನಿಯನ್ನು ಹಿಂದೆ ಹಾಕಿ ನಾಲ್ಕನೇ ಅತಿದೊಡ್ಡ ಮತ್ತು 2034 ರಲ್ಲಿ ಜಪಾನ್ ಅನ್ನು ಹಿಂದೆ ತಳ್ಳಿ ಮೂರನೇ ಅತಿದೊಡ್ಡ ಆರ್ಥಿಕ ರಾಷ್ಟ್ರವಾಗಲಿದೆ.
If we wish for India to have a thriving and sustainable economic growth trajectory to create a $5-trillion economy by 2024then we must strive to build a knowledge economy	ಭಾರತವನ್ನು 2024 ರ ಹೊತ್ತಿಗೆ 5-ಟ್ರಿಲಿಯನ್ ಡಾಲರ್ ಆರ್ಥಿಕತೆಯ ರಾಷ್ಟ್ರವಾಗಿ ಮಾರ್ಪಡಿಸಲು ವೇಗದ ಬೆಳವಣಿಗೆ ಮತ್ತು ಸುಸ್ಥಿರ ಆರ್ಥಿಕ ಪಥದಲ್ಲಿ ಸಾಗಬೇಕು ಎಂದು ನಾವು ಬಯಸುವುದಾದರೆ, - ಆಗ ನಾವು ಜ್ಞಾನ ಆರ್ಥಿಕತೆಯ ನಿರ್ಮಾಣಕ್ಕೆ ಶ್ರಮಿಸಬೇಕು.
There is a deep and inseverable connection between a nations educational institutions and its economic wellbeing	ರಾಷ್ಟ್ರದ ಶಿಕ್ಷಣ ಸಂಸ್ಥೆಗಳು ಮತ್ತು ಅದರ ಆರ್ಥಿಕ ಯೋಗಕ್ಷೇಮದ ನಡುವೆ ಆಳವಾದ ಮತ್ತು ಬೇರ್ಪಡಿಸಲಾಗದಂಥ ನಂಟಿದೆ.
For this to happen, we must constantly reform our institutions of higher education	ಇದು ಸಾಕಾರವಾಗಬೇಕಾದರೆ, ನಾವು ನಿರಂತರವಾಗಿ ನಮ್ಮ ಉನ್ನತ ಶಿಕ್ಷಣ ಸಂಸ್ಥೆಗಳನ್ನು ಸುಧಾರಣೆ ಮಾಡಲೇಬೇಕು.
Through well laid out mentoring plans, the mentor would interact with his disciples on a score of subjects and provide knowledge, cultivate skills and foster the attitude that was necessary for a successful, happy and accomplished life	ಉತ್ತಮವಾಗಿ ರೂಪಿಸಲಾದ ಮಾರ್ಗದರ್ಶಿ ನೀತಿಗಳ ಮೂಲಕ, ಮಾರ್ಗದರ್ಶಕನು ತನ್ನ ಶಿಷ್ಯರೊಂದಿಗೆ ಹಲವಾರು ವಿಷಯಗಳ ಬಗ್ಗೆ ಸಂವಹನ ನಡೆಸುತ್ತಾನೆ ಮತ್ತು ಜ್ಞಾನವನ್ನು ಪಸರಿಸುತ್ತಾನೆ, ಕೌಶಲ್ಯಗಳನ್ನು ಬೆಳೆಸುತ್ತಾನೆ ಮತ್ತು ಯಶಸ್ವಿ, ಸಂತೋಷದ ಮತ್ತು ಸಾಧನೆಯ ಬದುಕಿಗೆ ಅಗತ್ಯವಾದ ಮನೋಭಾವವನ್ನು ಬೆಳೆಸುತ್ತಾನೆ.
Indias ancient centers of learning, Nalanda, Vikramsila, Takshashila and the likes of it were eulogized by one and all across the globe for their openness, commitment to quality and excellence	ಭಾರತದ ಪುರಾತನ ಕಲಿಕಾ ಕೇಂದ್ರಗಳಾಗಿದ್ದ ನಳಂದಾ, ವಿಕ್ರಮಶಿಲಾ, ತಕ್ಷಶಿಲಾ ಮತ್ತು ಅದೇ ತರಹದ ಕೇಂದ್ರಗಳು, ತಮ್ಮ ಮುಕ್ತತೆ, ಗುಣಮಟ್ಟ ಮತ್ತು ಉತ್ಕೃಷ್ಟ ಬದ್ಧತೆಯಿಂದಾಗಿ ಜಗತ್ತಿನಾದ್ಯಂತ ಎಲ್ಲರ ಪ್ರಶಂಸೆಗೆ ಪಾತ್ರವಾಗಿದ್ದವು.
My dear sisters and brothers,	ನನ್ನ ಆತ್ಮೀಯ ಸಹೋದರ, ಸಹೋದರಿಯರೇ,
We must first address the structural lacunae in our higher education system	ನಾವು ಮೊದಲು ನಮ್ಮ ಉನ್ನತ ಶಿಕ್ಷಣ ವ್ಯವಸ್ಥೆಯಲ್ಲಿನ ರಚನಾತ್ಮಕ ಲೋಪವನ್ನು ನಿವಾರಿಸಬೇಕು.
In its Strategy for New India @ 75 report the NITI Aayog has recommended that spending on education should be increased to at least 6 per cent of GDP by 2022	“ನವ ಭಾರತ @75ಕ್ಕೆ ಕಾರ್ಯತಂತ್ರ” ವರದಿಯಲ್ಲಿ ನೀತಿ ಆಯೋಗವು ಶಿಕ್ಷಣದ ಮೇಲಿನ ವೆಚ್ಚವನ್ನು 2022ರ ಹೊತ್ತಿಗೆ ಜಿಡಿಪಿಯ ಕನಿಷ್ಠ 6ಕ್ಕೆ ಹೆಚ್ಚಿಸುವಂತೆ ಶಿಫಾರಸು ಮಾಡಿದೆ.
In a welcome move last year, the University Grants Commission took steps to fill around 50,000 vacancies in Institutions of higher education	ಕಳೆದ ವರ್ಷ ಸ್ವಾಗತಾರ್ಹವಾದ ಕ್ರಮದಲ್ಲಿ, ಉನ್ನತ ಶಿಕ್ಷಣ ಸಂಸ್ಥೆಗಳಲ್ಲಿ ಸುಮಾರು 50,000 ಖಾಲಿ ಹುದ್ದೆಗಳನ್ನು ಭರ್ತಿ ಮಾಡಲು ವಿಶ್ವವಿದ್ಯಾಲಯ ಧನಸಹಾಯ ಆಯೋಗ ಕ್ರಮ ಕೈಗೊಂಡಿದೆ.
Along with filling vacancies, we must also keep augmenting the knowledge, skills and capabilities of our teaching faculty	ಖಾಲಿ ಹುದ್ದೆಗಳನ್ನು ಭರ್ತಿ ಮಾಡುವುದರ ಜೊತೆಗೆ, ನಾವು ನಮ್ಮ ಬೋಧಕವರ್ಗದ ಜ್ಞಾನ, ಕೌಶಲ ಮತ್ತು ದಕ್ಷತೆ ಹೆಚ್ಚಿಸಲೂ ತ್ವರೆ ಮಾಡಬೇಕು.
They must be encouraged to pursue new knowledge and explore new teaching methodologies	ಅವರಿಗೆ ನೂತನ ಜ್ಞಾನ ಮತ್ತು ಹೊಸ ಬೋಧನಾ ವಿಧಾನಗಳನ್ನು ಶೋಧಿಸಲು ಉತ್ತೇಜಿಸಬೇಕು.
Their training must not be a one-time initiative but must be a continuous process	ಅವರಿಗೆ ತರಬೇತಿ ನೀಡುವ ಪ್ರಕ್ರಿಯೆ ಕೇವಲ ಒಂದು ಬಾರಿ ಆಗಬಾರದು ಅದು ನಿರಂತ್ರ ಪ್ರಕ್ರಿಯೆ ಆಗಬೇಕು
Quality of teaching faculty has a great bearing on learning outcomes	ಬೋಧಕ ಸಿಬ್ಬಂದಿಯ ಗುಣಮಟ್ಟವು ಕಲಿಕೆಯ ಫಲಶ್ರುತಿಯಲ್ಲಿ ಪ್ರಮುಖ ಅಂಶವಾಗಿದೆ.
In this age of Information Technology, the conventional role played by teachers has undergone a massive transformation	ಈ ಮಾಹಿತಿ ತಂತ್ರಜ್ಞಾನ ಯುಗದಲ್ಲಿ, ಶಿಕ್ಷಕರು ನಿರ್ವಹಿಸುವ ಸಾಂಪ್ರದಾಯಿಕ ಪಾತ್ರವು ಬೃಹತ್ ಬದಲಾವಣೆಯಲ್ಲಿ ಸಾಗಿದೆ.
Another area that we must focus on is Research and Development	ನಾವು ಗಮನ ಹರಿಸಬೇಕಾದ ಮತ್ತೊಂದು ಕ್ಷೇತ್ರ ಸಂಶೋಧನೆ ಮತ್ತು ಅಭಿವೃದ್ಧಿ.
Innovation is the watchword of the 21st century	ನಾವಿನ್ಯತೆ 21ನೇ ಶತಮಾನದ ಉದ್ಗಾರವಾಗಿದೆ.
The array of problems that we face today, from declining agricultural productivity to climate change, from challenges of urban development to threats to human health, can be tackled through Science, Technology and innovation	ಕೃಷಿ ಉತ್ಪಾದಕತೆಯು ಕ್ಷೀಣಿಸುವುದರಿಂದ ಹಿಡಿದು ಹವಾಮಾನ ಬದಲಾವಣೆಯವರೆಗೆ, ನಗರ ಅಭಿವೃದ್ಧಿಯ ಸವಾಲುಗಳಿಂದ ಹಿಡಿದು ಮಾನವನ ಆರೋಗ್ಯಕ್ಕೆ ಬೆದರಿಕೆಗಳವರೆಗೆ ನಾವು ಇಂದು ಎದುರಿಸುತ್ತಿರುವ ಎಲ್ಲ ಸಮಸ್ಯೆಗಳ ಶ್ರೇಣಿಯನ್ನು ವಿಜ್ಞಾನ, ತಂತ್ರಜ್ಞಾನ ಮತ್ತು ನಾವೀನ್ಯತೆಗಳ ಮೂಲಕ ನಿಭಾಯಿಸಬಹುದಾಗಿದೆ.
Teaching cannot be separated from research	ಬೋಧನೆಯನ್ನು ಸಂಶೋಧನೆಯಿಂದ ಪ್ರತ್ಯೇಕಗೊಳಿಸಲು ಸಾಧ್ಯವಿಲ್ಲ.
The Council of Scientific and Industrial Research, at rank 155, was our highest in the Scimago Institutions Rankings (SIR) for research	ವೈಜ್ಞಾನಿಕ ಮತ್ತು ಕೈಗಾರಿಕಾ ಸಂಶೋಧನಾ ಮಂಡಳಿ ಸಂಶೋಧನೆಯಲ್ಲಿ 155ನೇ ಸ್ಥಾನದಲ್ಲಿರುವುದೇ ಸಿಮಾಗೋ ಸಂಸ್ಥೆಗಳ ಶ್ರೇಣೀಕರಣದಲ್ಲಿ  ಅತ್ಯುನ್ನತವಾದುದಾಗಿದೆ.
There are over a one lakh India-born PhDs in universities around the world	ವಿಶ್ವದಾದ್ಯಂತದ ವಿಶ್ವವಿದ್ಯಾಲಯಗಳಲ್ಲಿ ಒಂದು ಲಕ್ಷಕ್ಕೂ ಹೆಚ್ಚು ಭಾರತೀಯ ಸಂಜಾತರ ಪಿಎಚ್‌ಡಿ ಪದವಿಧರರಿದ್ದಾರೆ.
We must also not hesitate to collaborate with the best universities and research centers around the world for knowledge sharing and capacity building	ನಾವು ಜ್ಞಾನ ವಿನಿಮಯ ಮತ್ತು ಸಾಮರ್ಥ್ಯ ವರ್ಧನೆಗಾಗಿ ವಿಶ್ವಾದ್ಯಂತದ ಅತ್ಯುತ್ತಮವಾದ ವಿಶ್ವವಿದ್ಯಾಲಯಗಳು ಮತ್ತು ಸಂಶೋಧನಾ ಕೇಂದ್ರಗಳೊಂದಿಗೆ ಸಹಯೋಗ ಹೊಂದಲು ಹಿಂಜರಿಯಬಾರದು.
We must boost the employability quotient of our students through practical training, internships, simulation exercises and case study-based training.	ನಾವು ಪ್ರಾಯೋಗಿಕ ತರಬೇತಿ, ಇಂಟರ್ನ್ ಷಿಪ್, ಅಣಕು ಪ್ರದರ್ಶನ ಮತ್ತು ಪ್ರಕರಣ ಆಧಾರಿತ ಅಧ್ಯಯನ ತರಬೇತಿಗಳ ಮೂಲಕ ನಮ್ಮ ವಿದ್ಯಾರ್ಥಿಗಳಲ್ಲಿ ಉದ್ಯೋಗದ ಸಾಮರ್ಥ್ಯವನ್ನು ಉತ್ತೇಜಿಸಬೇಕು.
We must also impart soft skills which are a combination of people skills, social skills, communication skills, character or personality traits, attitudes, social intelligence and emotional intelligence quotients, among others, that will enable youngsters to work well with others, perform well, and achieve their goals.	ಜನರ ಕೌಶಲ್ಯಗಳು, ಸಾಮಾಜಿಕ ಕೌಶಲ್ಯಗಳು, ಸಂವಹನ ಕೌಶಲ್ಯಗಳು, ಸ್ವಭಾವ ಅಥವಾ ವ್ಯಕ್ತಿತ್ವದ ಲಕ್ಷಣಗಳು, ವರ್ತನೆಗಳು, ಸಾಮಾಜಿಕ ಬುದ್ಧಿವಂತಿಕೆ ಮತ್ತು ಭಾವನಾತ್ಮಕ ಬುದ್ಧಿವಂತಿಕೆಯ ಅಂಶಗಳ ಸಂಯೋಜನೆಯಾದ ಮೃದು ಕೌಶಲ್ಯಗಳನ್ನು ಸಹ ನಾವು ನೀಡಬೇಕು, ಅದು ಯುವಜನರಿಗೆ ಇತರರೊಂದಿಗೆ ಉತ್ತಮವಾಗಿ ಕಾರ್ಯನಿರ್ವಹಿಸಲು, ಉತ್ತಮ ಪ್ರದರ್ಶನ ನೀಡಲು, ಮತ್ತು ಅವರ ಗುರಿಗಳನ್ನು ಸಾಧಿಸಲು ಅವಕಾಶ ಕಲ್ಪಿಸುತ್ತದೆನಾವು ನಮ್ಮ ಯುವಜನರಿಗೆ ನೀಡುವ ಶಿಕ್ಷಣ ಸಹ ಮೌಲ್ಯಾಧಾರಿತವಾಗಿರಬೇಕು.
The world is now a global village	ಇಂದು ವಿಶ್ವವೇ ಒಂದು ಜಾಗತಿಕ ಗ್ರಾಮ.
Our children, when they leave the portals of the educational institutions must be enlightened citizens who will take an abiding interest in protecting our democracy and preserving the fundamental values that are enshrined in our constitution	ನಮ್ಮ ಮಕ್ಕಳು, ಶಿಕ್ಷಣ ಸಂಸ್ಥೆಗಳಿಂದ ಹೊರ ಬಂದಾಗ ಅವರು ಪ್ರಬುದ್ಧ ನಾಗರಿಕರಾಗಿರಬೇಕು, ಅವರು ನಮ್ಮ ಪ್ರಜಾಪ್ರಭುತ್ವವನ್ನು ರಕ್ಷಿಸಲು ಮತ್ತು ನಮ್ಮ ಸಂವಿಧಾನದಲ್ಲಿ ಪ್ರತಿಪಾದಿಸಿರುವ ಮೂಲಭೂತ ಮೌಲ್ಯಗಳನ್ನು ಕಾಪಾಡುವಲ್ಲಿ ನಿರಂತರ ಆಸಕ್ತಿ ವಹಿಸುವಂತಿರಬೇಕು.
Once again, I congratulate NAAC on attaining this crucial mile-stone.	ಮಹತ್ವದ ಮೈಲಿಗಲ್ಲು ಸಾಧಿಸಿದ ನ್ಯಾಕ್ ಗೆ ಮತ್ತೊಮ್ಮೆ ನಾನು ಅಭಿನಂದನೆ ಸಲ್ಲಿಸುತ್ತೇನೆ.
Vice President asks scientists to find long-term solutions to farmers problems	ರೈತರ ಸಮಸ್ಯೆಗಳಿಗೆ ದೀರ್ಘಕಾಲೀನ ಪರಿಹಾರಗಳನ್ನು ಕಂಡುಕೊಳ್ಳುವಂತೆ  ವಿಜ್ಞಾನಿಗಳಿಗೆ ಉಪ ರಾಷ್ಟ್ರಪತಿ ಕರೆ
Vice President asks scientists to find long-term solutions to farmers problems	ರೈತರ ಸಮಸ್ಯೆಗಳಿಗೆ ದೀರ್ಘಕಾಲೀನ ಪರಿಹಾರಗಳನ್ನು ಕಂಡುಕೊಳ್ಳುವಂತೆ  ವಿಜ್ಞಾನಿಗಳಿಗೆ ಉಪ ರಾಷ್ಟ್ರಪತಿ ಕರೆ
Delivers Valedictory Address at the 107th Indian Science Congress	107 ನೇ ಭಾರತೀಯ ವಿಜ್ಞಾನ ಕಾಂಗ್ರೆಸ್‌ನಲ್ಲಿ ಸಮಾರೋಪ ಭಾಷಣ
He also wanted scientists to explore ways to make crops climate-resilient, nutrition-efficient and less water consuming.	ಬೆಳೆಗಳು ಹವಾಮಾನ-ಸ್ಥಿತಿಸ್ಥಾಪಕ, ಪೌಷ್ಠಿಕಾಂಶ-ಪರಿಣಾಮಕಾರಿ ಮತ್ತು ಮಿತವ್ಯಯ ನೀರು ಬಳಕೆ ವಿಧಾನಗಳ ಕುರಿತು ವಿಜ್ಞಾನಿಗಳು ಅನ್ವೇಷಿಸಬೇಕೆಂದು ಅವರು ಸಲಹೆ ಮಾಡಿದರು.
Delivering the Valedictory Speech at the 107th Indian Science Congress in Bengaluru, the Vice President said that global warming and climate change were affecting the weather patterns in an unpredictable manner and causing massive devastation at times	ಬೆಂಗಳೂರಿನಲ್ಲಿ ನಡೆದ 107 ನೇ ಭಾರತೀಯ ವಿಜ್ಞಾನ ಕಾಂಗ್ರೆಸ್‌ನಲ್ಲಿ ಸಮಾರೋಪ ಭಾಷಣ ಮಾಡಿದ ಉಪ ರಾಷ್ಟ್ರಪತಿಯವರು, ಜಾಗತಿಕ ತಾಪಮಾನ ಮತ್ತು ಹವಾಮಾನ ಬದಲಾವಣೆಯು ಹವಾಮಾನದ ಮೇಲೆ ಅನಿರೀಕ್ಷಿತ ರೀತಿಯಲ್ಲಿ ಪರಿಣಾಮ ಬೀರುತ್ತಿದೆ ಮತ್ತು ಕೆಲವೊಮ್ಮೆ ಭಾರೀ ವಿನಾಶಕ್ಕೆ ಕಾರಣವಾಗುತ್ತಿದೆ.
He sought to know from the scientists whether the problems faced by farmers due to natures fury could be mitigated.	ಪ್ರಕೃತಿಯ ವಿಕೋಪದಿಂದಾಗಿ ರೈತರು ಎದುರಿಸುತ್ತಿರುವ ಸಮಸ್ಯೆಗಳನ್ನು ತಗ್ಗಿಸಬಹುದೇ ಎಂದು ಅವರು ವಿಜ್ಞಾನಿಗಳನ್ನು ಕೇಳಿದರು.
Calling for concerted efforts, Shri Naidu emphasized upon the critical role of technology in enhancing both the quality and quantity across the agriculture value chain from the use of inputs at the pre-production stage to post-production and marketing to improve the income of farmers.	ಸಮಗ್ರ ಪ್ರಯತ್ನಗಳಿಗೆ ಕರೆ ನೀಡಿದ ಉಪ ರಾಷ್ಟ್ರಪತಿ  ಶ್ರೀ ನಾಯ್ಡು, ಉತ್ಪಾದನಾ ಪೂರ್ವ ಹಂತದಿಂದ ಉತ್ಪಾದನೆ-ನಂತರ ಮತ್ತು ಮಾರುಕಟ್ಟೆಯವರೆಗೆ ರೈತರ ಆದಾಯವನ್ನು ಸುಧಾರಿಸಲು ಕೃಷಿ ಮೌಲ್ಯ ಸರಪಳಿಯಲ್ಲಿ ಗುಣಮಟ್ಟ ಮತ್ತು ಪ್ರಮಾಣ ಎರಡನ್ನೂ ಹೆಚ್ಚಿಸುವಲ್ಲಿ ತಂತ್ರಜ್ಞಾನದ ನಿರ್ಣಾಯಕ ಪಾತ್ರವನ್ನು ಒತ್ತಿಹೇಳಿದರು,
At the same time, new challenges are arising- science must find solutions to problems like increasing urbanization, pollution, urban-rural divide, growing antibacterial resistance, genetic & non-communicable diseases, water scarcity, among others	ಹಾಗೆಯೇ ಹೊಸ ಸವಾಲುಗಳು ಸಹ ಉದ್ಭವಿಸುತ್ತಿವೆ ಎಂದ ಉಪ ರಾಷ್ಟ್ರಪತಿಯವರು, ಹೆಚ್ಚುತ್ತಿರುವ ನಗರೀಕರಣ, ಮಾಲಿನ್ಯ, ನಗರ-ಗ್ರಾಮೀಣ ವಿಭಜನೆ, ಕುಸಿಯುತ್ತಿರುವ ನಿರೋಧಕ ಶಕ್ತಿ, ಹೆಚ್ಚುತ್ತಿರುವ ಆನುವಂಶಿಕ ಮತ್ತು ಸಾಂಕ್ರಾಮಿಕವಲ್ಲದ ಕಾಯಿಲೆಗಳು ಮತ್ತು ನೀರಿನ ಕೊರತೆ ಮುಂತಾದ ಸಮಸ್ಯೆಗಳಿಗೆ ವಿಜ್ಞಾನವು ಪರಿಹಾರಗಳನ್ನು ಕಂಡುಕೊಳ್ಳಬೇಕು ಎಂದರು.
Urging schools to lay the foundation for the spread of a strong scientific culture in the country, he stressed that such a foundation would become the basis for creating an ecosystem for creativity and innovation to thrive.	ದೇಶದಲ್ಲಿ ಬಲವಾದ ವೈಜ್ಞಾನಿಕ ಸಂಸ್ಕೃತಿಯನ್ನು ಪಸರಿಸಲು ಅಡಿಪಾಯ ಹಾಕಬೇಕೆಂದು ಶಾಲೆಗಳಿಗೆ ಒತ್ತಾಯಿಸಿದ ಅವರು, ಅಂತಹ ಅಡಿಪಾಯವು ಸೃಜನಶೀಲತೆ ಮತ್ತು ನಾವೀನ್ಯತೆ ಅಭಿವೃದ್ಧಿಗೆ ವ್ಯವಸ್ಥೆಯನ್ನು ಸೃಷ್ಟಿಸಲು ಆಧಾರವಾಗಲಿದೆ ಎಂದು ಒತ್ತಿ ಹೇಳಿದರು.
The need of the hour is to foster the spirit of inquisitiveness, curiosity and scientific temper right from the primary school level, he said.	ಪ್ರಾಥಮಿಕ ಶಾಲಾ ಹಂತದಿಂದಲೇ ಜಿಜ್ಞಾಸೆ, ಕುತೂಹಲ ಮತ್ತು ವೈಜ್ಞಾನಿಕ ಮನೋಭಾವವನ್ನು ಬೆಳೆಸುವುದು ಇಂದಿನ ಅಗತ್ಯವಾಗಿದೆಎಂದು ಅವರು ಹೇಳಿದರು.
Technological innovation was a key driver in boosting economy, improving peoples lives and enabling better delivery of services he added.	ತಾಂತ್ರಿಕ ಆವಿಷ್ಕಾರವು ಆರ್ಥಿಕತೆಯನ್ನು ಉತ್ತೇಜಿಸುವ, ಜನರ ಜೀವನವನ್ನು ಸುಧಾರಿಸುವ ಮತ್ತು ಸೇವೆಗಳ ಉತ್ತಮ ವಿತರಣೆಯನ್ನು ಶಕ್ತಗೊಳಿಸುವ ಪ್ರಮುಖ ಚಾಲಕ ಅಂಶಗಳಲ್ಲೊಂದಾಗಿದೆ ಎಂದರು.
India like no other country has a huge demographic dividend and can emerge as the innovation and knowledge if our universities and scientific institutions invest more on R & D and significantly the raise the standards of research, Shri Naidu stressed.	ನಮ್ಮ ವಿಶ್ವವಿದ್ಯಾಲಯಗಳು ಮತ್ತು ವೈಜ್ಞಾನಿಕ ಸಂಸ್ಥೆಗಳು ಆರ್ & ಡಿ ಮೇಲೆ ಹೆಚ್ಚು ಹೂಡಿಕೆ ಮಾಡಿದರೆ ಮತ್ತು ಸಂಶೋಧನೆಯ ಗುಣಮಟ್ಟವನ್ನು ಗಮನಾರ್ಹವಾಗಿ ಹೆಚ್ಚಿಸಿದರೆ ಈ ಜನಸಂಖ್ಯೆಯು ನಾವೀನ್ಯತೆ ಮತ್ತು ಜ್ಞಾನವಾಗಿ ಹೊರಹೊಮ್ಮಬಹುದುಎಂದು ಉಪ ರಾಷ್ಟ್ರಪತಿ  ಶ್ರೀ ನಾಯ್ಡು ಒತ್ತಿ ಹೇಳಿದರು.
The Vice President also urged the corporate India to develop a symbiotic partnership with the universities and to identify and fund a dozen futuristic projects.	ಕಾರ್ಪೊರೇಟ್ ಭಾರತವು ವಿಶ್ವವಿದ್ಯಾನಿಲಯಗಳೊಂದಿಗೆ ಸಹಭಾಗಿತ್ವವನ್ನು ಬೆಳೆಸಿಕೊಳ್ಳಬೇಕು ಮತ್ತು ಒಂದು ಡಜನ್ ಭವಿಷ್ಯದ ಯೋಜನೆಗಳನ್ನು ಗುರುತಿಸಿ ಹಣ ಒದಗಿಸಬೇಕು ಎಂದು ಉಪ ರಾಷ್ಟ್ರಪತಿಯವರು ಒತ್ತಾಯಿಸಿದರು.
Opining that India was surging forward with renewed vigour and enthusiasm, the Vice President said that it must leverage the demographic opportunity with science and technology playing a leading role in driving the economic and social development in order to make the country a $ 5 trillion economy.	ಭಾರತವು ಹೊಸ ಚೈತನ್ಯ ಮತ್ತು ಉತ್ಸಾಹದಿಂದ ಮುನ್ನುಗ್ಗುತ್ತಿದೆ ಎಂದ ಉಪರಾಷ್ಟ್ರಪತಿಯವರು, ದೇಶವನ್ನು 5 ಟ್ರಿಲಿಯನ್ ಡಾಲರ್ ಆರ್ಥಿಕತೆಯನ್ನಾಗಿ ಮಾಡಲು ಆರ್ಥಿಕ ಮತ್ತು ಸಾಮಾಜಿಕ ಅಭಿವೃದ್ಧಿಗೆ ಚಾಲನೆ ನೀಡುವಲ್ಲಿ ವಿಜ್ಞಾನ ಮತ್ತು ತಂತ್ರಜ್ಞಾನವು ಪ್ರಮುಖ ಪಾತ್ರ ವಹಿಸುವ ಮೂಲಕ ಜನಸಂಖ್ಯೆಯ ಅವಕಾಶವನ್ನು ಸದುಪಯೋಗಪಡಿಸಿಕೊಳ್ಳಬೇಕು ಎಂದು ಹೇಳಿದರು.
Shri Naidu lauded the government initiatives such as Make in India, Digital India and Start-Up India that promote indigenous manufacturing, empower people digitally and wealth-creation through innovation.	ಸ್ಥಳೀಯ ಉತ್ಪಾದನೆಯನ್ನು ಉತ್ತೇಜಿಸುವ, ಜನರನ್ನು ಡಿಜಿಟಲ್ ರೂಪದಲ್ಲಿ ಸಬಲೀಕರಣಗೊಳಿಸುವ ಮತ್ತು ನಾವೀನ್ಯತೆಯ ಮೂಲಕ ಸಂಪತ್ತು ಸೃಷ್ಟಿಸುವ ಸರ್ಕಾರದ ಉಪಕ್ರಮಗಳಾದ ಮೇಕ್ ಇನ್ ಇಂಡಿಯಾ, ಡಿಜಿಟಲ್ ಇಂಡಿಯಾ ಮತ್ತು ಸ್ಟಾರ್ಟ್ ಅಪ್ ಇಂಡಿಯಾವನ್ನು ಶ್ರೀ ನಾಯ್ಡು ಶ್ಲಾಘಿಸಿದರು.
He wanted senior scientists to mentor and hand-hold the young ones to benefit from such schemes and realize their scientific and entrepreneurial potential.	ಅಂತಹ ಯೋಜನೆಗಳಿಂದ ಪ್ರಯೋಜನ ಪಡೆಯಲು ಮತ್ತು ಅವರ ವೈಜ್ಞಾನಿಕ ಮತ್ತು ಉದ್ಯಮಶೀಲತೆಯ ಸಾಮರ್ಥ್ಯವನ್ನು ಅರಿತುಕೊಳ್ಳಲು ಹಿರಿಯ ವಿಜ್ಞಾನಿಗಳು ಯುವಕರಿಗೆ ಮಾರ್ಗದರ್ಶನ ಮತ್ತು ಸಹಾಯ ಹಸ್ತ ನೀಡಬೇಕು ಅವರು ಬಯಸಿದರು.
Chief Minister of Karnataka, Shri BYediyurappa,General President of Indian Sciences Congress, KRangappa, and the, Vice-Chancellor, University of Agricultural Sciences, Bengaluru, DrRajendra Prasad were among the dignitaries who graced the occasion.	ಯಡಿಯೂರಪ್ಪ, ಭಾರತೀಯ ವಿಜ್ಞಾನ ಕಾಂಗ್ರೆಸ್ ಪ್ರಧಾನ ಅಧ್ಯಕ್ಷ ಕೆ ಸ್ ಂಗಪ್ಪ, ಮತ್ತು ಬೆಂಗಳೂರು ಕೃಷಿ ವಿಜ್ಞಾನ ವಿಶ್ವವಿದ್ಯಾಲಯದ ಉಪಕುಲಪತಿ ಡಾ.
I am delighted to deliver the valedictory address at the 107th Indian Science Congress, a prestigious annual event.	ಪ್ರತಿಷ್ಠಿತ 107 ನೇ ಭಾರತೀಯ ವಿಜ್ಞಾನ ಕಾಂಗ್ರೆಸ್‌ನ ಸಮಾರೋಪ ಭಾಷಣ ಮಾಡಲು ನನಗೆ ಸಂತೋಷವಾಗುತ್ತಿದೆ.
It is quite appropriate that this important meeting of scientific minds is being held on the campus of an Agricultural University	ವೈಜ್ಞಾನಿಕ ಮನಸ್ಸುಗಳ ಈ ಮಹತ್ವದ ಸಭೆಯು ಕೃಷಿ ವಿಶ್ವವಿದ್ಯಾಲಯದ ಆವರಣದಲ್ಲಿ ನಡೆಯುತ್ತಿರುವುದು ಸೂಕ್ತವಾಗಿದೆ.
As you all are aware, agriculture plays a vital role in the overall growth of the economy.	ನೀವೆಲ್ಲರೂ ತಿಳಿದಿರುವಂತೆ, ಆರ್ಥಿಕತೆಯ ಒಟ್ಟಾರೆ ಬೆಳವಣಿಗೆಯಲ್ಲಿ ಕೃಷಿ ಪ್ರಮುಖ ಪಾತ್ರ ವಹಿಸುತ್ತದೆ.
For the past many years, agriculture has been facing distress in spite of the measures taken by successive governments at the Centre and in various States to improve crop productivity and incomes of the farmers.	ಬೆಳೆ ಉತ್ಪಾದಕತೆ ಮತ್ತು ರೈತರ ಆದಾಯವನ್ನು ಸುಧಾರಿಸಲು ಕೇಂದ್ರದಲ್ಲಿ ಮತ್ತು ವಿವಿಧ ರಾಜ್ಯಗಳಲ್ಲಿ ಸರ್ಕಾರಗಳು ಕೈಗೊಂಡ ಸತತ ಕ್ರಮಗಳ ನಡುವೆಯೂ ಕಳೆದ ಹಲವು ವರ್ಷಗಳಿಂದ ಕೃಷಿ ಕ್ಷೇತ್ರವು ಸಂಕಷ್ಟವನ್ನು ಎದುರಿಸುತ್ತಿದೆ.
Agriculture is close to my heart as I come from a farmers family	ನಾನು ರೈತ ಕುಟುಂಬದಿಂದ ಬಂದಿರುವುದರಿಂದ ಕೃಷಿ ನನ್ನ ಹೃದಯಕ್ಕೆ ಹತ್ತಿರವಾಗಿದೆ.
I understand the pain and suffering of farmers when they face adverse seasonal conditions or natural calamities.	ಋತುಮಾನದ ಪ್ರತಿಕೂಲ ಪರಿಸ್ಥಿತಿಗಳು ಅಥವಾ ನೈಸರ್ಗಿಕ ವಿಪತ್ತುಗಳನ್ನು ಎದುರಿಸಿದಾಗ ರೈತರು ಅನುಭವಿಸುವ ನೋವು ಮತ್ತು ಸಂಕಟಗಳನ್ನು ನಾನು ಅರ್ಥಮಾಡಿಕೊಂಡಿದ್ದೇನೆ.
Can we not mitigate the problems faced by farmers due to natures fury?	ಪ್ರಕೃತಿಯ ಕೋಪದಿಂದ ರೈತರು ಎದುರಿಸುತ್ತಿರುವ ಸಮಸ್ಯೆಗಳನ್ನು ನಾವು ತಗ್ಗಿಸಲು ಸಾಧ್ಯವಿಲ್ಲವೇ?
Can science throw up answers to these and other pressing problems faced by the farmers?	ರೈತರು ಎದುರಿಸುತ್ತಿರುವ ಇಂತಹ ಸಮಸ್ಯೆಗಳಿಗೆ ವಿಜ್ಞಾನವು ಉತ್ತರಗಳನ್ನು ನೀಡಬಹುದೇ?
How to improve soil fertility?	ಮಣ್ಣಿನ ಫಲವತ್ತತೆಯನ್ನು ಸುಧಾರಿಸುವುದು ಹೇಗೆ?
How to make crops climate-resilient and nutrition-efficient?	ಬೆಳೆಗಳನ್ನು ಹವಾಮಾನ-ಸ್ಥಿತಿಸ್ಥಾಪಕ ಮತ್ತು ಪೋಷಕಾಂಶಯುಕ್ತಗೊಳಿಸುವುದು ಹೇಗೆ?
How to improve productivity with less water consumption?	ಕಡಿಮೆ ನೀರಿನ ಬಳಕೆಯೊಂದಿಗೆ ಉತ್ಪಾದಕತೆಯನ್ನು ಸುಧಾರಿಸುವುದು ಹೇಗೆ?
We need to have our own home-grown food security	ನಾವು ನಮ್ಮದೇ ನೆಲದಲ್ಲಿ ಬೆಳೆದ ಆಹಾರ ಭದ್ರತೆಯನ್ನು ಹೊಂದಿರಬೇಕು.
Unless there are concerted efforts in this direction, I am afraid that more and more people will leave agriculture and shift to other occupations.	ಈ ದಿಕ್ಕಿನಲ್ಲಿ ಏಕೀಕೃತ ಪ್ರಯತ್ನಗಳಿಲ್ಲದಿದ್ದರೆ, ಹೆಚ್ಚು ಹೆಚ್ಚು ಜನರು ಕೃಷಿಯನ್ನು ತೊರೆದು ಇತರ ಉದ್ಯೋಗಗಳಿಗೆ ಸ್ಥಳಾಂತರಗೊಳ್ಳುತ್ತಾರೆ ಎಂಬ ಭಯ ನನಗಿದೆ.
I dont think I need to overemphasize the critical role technology can play in enhancing both the quality and quantity across the agriculture value chain from the use of inputs at the pre-production stage to post-production storage, processing, packaging and marketing to improve the income of farmers.	ರೈತರ ಆದಾಯವನ್ನು ಸುಧಾರಿಸಲು ಉತ್ಪಾದನಾ ಪೂರ್ವ ಹಂತದಿಂದ ಉತ್ಪಾದನೆಯ ನಂತರದ ಸಂಗ್ರಹಣೆ, ಸಂಸ್ಕರಣೆ, ಪ್ಯಾಕೇಜಿಂಗ್ ಮತ್ತು ಮಾರುಕಟ್ಟೆಯವರೆಗಿನ ಕೃಷಿ ಮೌಲ್ಯ ಸರಪಳಿಯಲ್ಲಿ ಗುಣಮಟ್ಟ ಮತ್ತು ಪ್ರಮಾಣ ಎರಡನ್ನೂ ಹೆಚ್ಚಿಸುವಲ್ಲಿ ತಂತ್ರಜ್ಞಾನವು ವಹಿಸಬಹುದಾದ ನಿರ್ಣಾಯಕ ಪಾತ್ರವನ್ನು ನಾನು ಒತ್ತಿ ಹೇಳಬೇಕಾಗಿಲ್ಲ ಎಂದು ಭಾವಿಸುತ್ತೇನೆ.
The use of technology, including ICT, would not only help improve efficiency but would also result in reducing the cost of production	ಐಸಿಟಿ ಸೇರಿದಂತೆ ತಂತ್ರಜ್ಞಾನದ ಬಳಕೆಯು, ದಕ್ಷತೆಯನ್ನು ಸುಧಾರಿಸಲು ಮಾತ್ರವಲ್ಲ ಉತ್ಪಾದನಾ ವೆಚ್ಚವನ್ನು ಕಡಿಮೆ ಮಾಡಲೂ ಸಹ ನೆರವಾಗುತ್ತದೆ.
Scientific research should also focus on making advanced machinery for a variety of agricultural activities from spraying to post-harvest handling of produce	ಸಿಂಪಡಿಸುವಿಕೆಯಿಂದ ಹಿಡಿದು ಸುಗ್ಗಿಯ ನಂತರದ ಉತ್ಪನ್ನಗಳನ್ನು ನಿರ್ವಹಿಸುವವರೆಗೆ ವಿವಿಧ ಕೃಷಿ ಚಟುವಟಿಕೆಗಳಿಗೆ ಸುಧಾರಿತ ಯಂತ್ರೋಪಕರಣಗಳನ್ನು ತಯಾರಿಸುವ ಬಗ್ಗೆ ವೈಜ್ಞಾನಿಕ ಸಂಶೋಧನೆಗಳು ಗಮನ ಹರಿಸಬೇಕು.
Thus, the adoption of modern technology can greatly help to realise our vision to double the income of farmers in the coming years.	ಹೀಗಾಗಿ, ಆಧುನಿಕ ತಂತ್ರಜ್ಞಾನದ ಅಳವಡಿಕೆಯು ಮುಂಬರುವ ವರ್ಷಗಳಲ್ಲಿ ರೈತರ ಆದಾಯವನ್ನು ದ್ವಿಗುಣಗೊಳಿಸುವ ನಮ್ಮ ದೃಷ್ಟಿಯನ್ನು ಸಾಕಾರಗೊಳಿಸಲು ನೆರವಾಗುತ್ತವೆ.
Dear sisters and brothers, new technological advances and inventions are changing our lives like never before	ಆತ್ಮೀಯ ಸೋದರ, ಸೋದರಿಯರೇ, ಹೊಸ ತಾಂತ್ರಿಕ ಪ್ರಗತಿಗಳು ಮತ್ತು ಆವಿಷ್ಕಾರಗಳು ನಮ್ಮ ಜೀವನವನ್ನು ಹಿಂದೆಂದಿಗಿಂತಲೂ ಹೆಚ್ಚಿನ ರೀತಿಯಲ್ಲಿ ಬದಲಾಯಿಸುತ್ತಿವೆ.
No doubt, these advances are making our lives more comfortable and improving the ease of living	ನಿಸ್ಸಂದೇಹವಾಗಿ, ಈ ಪ್ರಗತಿಗಳು ನಮ್ಮ ಜೀವನವನ್ನು ಹೆಚ್ಚು ಆರಾಮದಾಯಕವಾಗಿಸುತ್ತಿವೆ ಮತ್ತು ಜೀವನವನ್ನು  ಸುಲಭಗೊಳಿಸಿವೆ.
At the same time, new challenges are arising- science must find solutions to problems like increasing urbanization, pollution, urban-rural divide, growing antibacterial resistance, genetic & non-communicable diseases, water scarcity, among others	ಹಾಗೆಯೇ, ಹೊಸ ಸವಾಲುಗಳೂ ಉದ್ಭವಿಸುತ್ತಿವೆ- ಹೆಚ್ಚುತ್ತಿರುವ ನಗರೀಕರಣ, ಮಾಲಿನ್ಯ, ನಗರ-ಗ್ರಾಮೀಣ ವಿಭಜನೆ, ಕುಗ್ಗುತ್ತಿರುವ ನಿರೋಧಕ ಶಕ್ತಿ, ಹೆಚ್ಚುತ್ತಿರುವ ಆನುವಂಶಿಕ ಮತ್ತು ಸಾಂಕ್ರಾಮಿಕವಲ್ಲದ ಕಾಯಿಲೆಗಳು, ನೀರಿನ ಕೊರತೆ ಮುಂತಾದ ಸಮಸ್ಯೆಗಳಿಗೆ ವಿಜ್ಞಾನವು ಪರಿಹಾರಗಳನ್ನು ಕಂಡುಕೊಳ್ಳಬೇಕಿದೆ.
We must balance scientific advancement with the protection of environment	ನಾವು ವೈಜ್ಞಾನಿಕ ಪ್ರಗತಿಯನ್ನು ಪರಿಸರದ ಸಂರಕ್ಷಣೆಯೊಂದಿಗೆ ಸಮತೋಲನಗೊಳಿಸಬೇಕು.
In fact, that has been the Indian vision of holistic development	ವಾಸ್ತವವಾಗಿ, ಇದು ಸಮಗ್ರ ಅಭಿವೃದ್ಧಿಯ ಭಾರತೀಯ ದೃಷ್ಟಿಕೋನವಾಗಿದೆ.
I would like to recall what the famous Indian scientist AcharyaJagdish Chandra Bose had said while inaugurating the Bose Institute in 1917, about the multi-disciplinary approach and the inter-related aspects of life where the lines of physics, physiology and psychology converge.	1917 ರಲ್ಲಿ ಬೋಸ್ ಸಂಸ್ಥೆಯನ್ನು ಉದ್ಘಾಟಿಸುವಾಗ ಪ್ರಸಿದ್ಧ ಭಾರತೀಯ ವಿಜ್ಞಾನಿ ಆಚಾರ್ಯ ಜಗದೀಶ್ ಚಂದ್ರ ಬೋಸ್ ಅವರು ಬಹು-ಶಿಸ್ತಿನ ವಿಧಾನ ಮತ್ತು ಜೀವನದ ಅಂತರ-ಸಂಬಂಧಿತ ಅಂಶಗಳ ಬಗ್ಗೆ “ಭೌತಶಾಸ್ತ್ರ, ಶರೀರಶಾಸ್ತ್ರ ಮತ್ತು ಮನೋವಿಜ್ಞಾನದ ರೇಖೆಗಳ ಸಮನ್ವಯದ” ಬಗ್ಗೆ ಹೇಳಿದ್ದನ್ನು ನಾನು ಸ್ಮರಿಸುತ್ತೇನೆ.
In our labs and research centres, in our schools and colleges, we should create an ecosystem for innovation to thrive where the genius of India should find its true blossoming as Jagdish Chandra Bose had said.	ನಮ್ಮ ಪ್ರಯೋಗಾಲಯಗಳು ಮತ್ತು ಸಂಶೋಧನಾ ಕೇಂದ್ರಗಳಲ್ಲಿ, ನಮ್ಮ ಶಾಲೆಗಳು ಮತ್ತು ಕಾಲೇಜುಗಳಲ್ಲಿ, ಜಗದೀಶ್ ಚಂದ್ರ ಬೋಸ್ ಹೇಳಿದಂತೆ “ಭಾರತದ ಪ್ರತಿಭೆ ಅದರ ನಿಜವಾದ ಅರಳುವಿಕೆಯನ್ನು ಕಂಡುಕೊಳ್ಳುವಂತಾಗಲು”ನಾವು ಹೊಸತನವನ್ನು ಅಭಿವೃದ್ಧಿಪಡಿಸುವ ವ್ಯವಸ್ಥೆಯನ್ನು ಸೃಷ್ಟಿಸಬೇಕು.
Science teaching plays an important role in this regard	ಈ ವಿಷಯದಲ್ಲಿ ವಿಜ್ಞಾನ ಬೋಧನೆಯು ಪ್ರಮುಖ ಪಾತ್ರ ವಹಿಸುತ್ತದೆ.
It must ignite young minds and create a passion for science	ಅದು ಯುವ ಮನಸ್ಸುಗಳನ್ನು ಉದ್ಧೀಪಿಸಬೇಕು ಮತ್ತು ವಿಜ್ಞಾನದ ಬಗ್ಗೆ ಉತ್ಸಾಹವನ್ನು ಸೃಷ್ಟಿಸಬೇಕು.
Schools must sow the seeds for scientific temper and create an un-quenching curiosity to learn and understand new things.	ಶಾಲೆಗಳು ವೈಜ್ಞಾನಿಕ ಮನೋಭಾವಕ್ಕಾಗಿ ಬೀಜಗಳನ್ನು ಬಿತ್ತಬೇಕು ಮತ್ತು ಹೊಸ ವಿಷಯಗಳನ್ನು ಕಲಿಯಲು ಮತ್ತು ಅರ್ಥಮಾಡಿಕೊಳ್ಳಲು ಕುತೂಹಲವನ್ನು ಸೃಷ್ಟಿಸಬೇಕು.
In short, schools must lay the foundation for the spread of a strong scientific culture in the country	ಸಂಕ್ಷಿಪ್ತವಾಗಿ ಹೇಳುವುದಾದರೆ, ದೇಶದಲ್ಲಿ ಬಲವಾದ ವೈಜ್ಞಾನಿಕ ಸಂಸ್ಕೃತಿಯ ಹರಡುವಿಕೆಗೆ ಶಾಲೆಗಳು ಅಡಿಪಾಯ ಹಾಕಬೇಕು.
I am happy that Atal Tinkering Labs have been set up in thousands of schools across the country.	ದೇಶಾದ್ಯಂತ ಸಾವಿರಾರು ಶಾಲೆಗಳಲ್ಲಿ ಅಟಲ್ ಟಿಂಕರಿಂಗ್ ಲ್ಯಾಬ್‌ಗಳನ್ನು ಸ್ಥಾಪಿಸಲಾಗಿದೆ ಎಂಬುದು ನನಗೆ ಸಂತೋಷದ ವಿಚಾರವಾಗಿದೆ.
I am also glad that India has moved from 81st position in 2015 to 52nd rank in the Global Innovation Index in 2019	ಜಾಗತಿಕ ಇನ್ನೋವೇಶನ್ ಸೂಚ್ಯಂಕದಲ್ಲಿ ಭಾರತವು 2015 ರಲ್ಲಿದ್ದ 81 ನೇ ಸ್ಥಾನದಿಂದ 2019 ರಲ್ಲಿ 52 ನೇ ಸ್ಥಾನಕ್ಕೆ ಜಿಗಿದಿರುವುದು ಸಂತಸ ತಂದಿದೆ.
Technological innovation is one of the key drivers to boost economy, improve peoples lives and enable better delivery of services	ಆರ್ಥಿಕತೆಯನ್ನು ಉತ್ತೇಜಿಸಲು, ಜನರ ಜೀವನವನ್ನು ಸುಧಾರಿಸಲು ಮತ್ತು ಉತ್ತಮ ಸೇವೆಗಳನ್ನು ಒದಗಿಸಲು ತಾಂತ್ರಿಕ ನಾವೀನ್ಯತೆಯು ಪ್ರಮುಖ ಚಾಲಕ ಅಂಶಗಳಲ್ಲಿ ಒಂದಾಗಿದೆ.
We need to further improve our ranking in the coming years	ಮುಂಬರುವ ವರ್ಷಗಳಲ್ಲಿ ನಾವು ನಮ್ಮ ಶ್ರೇಯಾಂಕವನ್ನು ಇನ್ನಷ್ಟು ಸುಧಾರಿಸಬೇಕಾಗಿದೆ.
The academia-industry linkage has to be expanded not only to provide employment to those coming out of the portals of higher education institutions, but also to promote research and innovation in a big way.	ಉನ್ನತ ಶಿಕ್ಷಣ ಸಂಸ್ಥೆಗಳಿಂದ ಹೊರಬರುವವರಿಗೆ ಉದ್ಯೋಗವನ್ನು ಒದಗಿಸಲು ಮಾತ್ರವಲ್ಲದೆ ಸಂಶೋಧನೆ ಮತ್ತು ಆವಿಷ್ಕಾರಗಳನ್ನು ದೊಡ್ಡ ಪ್ರಮಾಣದಲ್ಲಿ ಉತ್ತೇಜಿಸಲು ಬೌದ್ಧಿಕ-ತಂತ್ರಜ್ಞಾನದ ಸಂಪರ್ಕವನ್ನು ವಿಸ್ತರಿಸಬೇಕಾಗಿದೆ.
If we dont make the big leap forward in terms of quality of learning in our educational institutions, we will have missed a great opportunity.	ನಮ್ಮ ಶಿಕ್ಷಣ ಸಂಸ್ಥೆಗಳಲ್ಲಿ ಕಲಿಕೆಯ ಗುಣಮಟ್ಟದ ದೃಷ್ಟಿಯಿಂದ ನಾವು ಹೆಚ್ಚಿನ ಮುನ್ನಡೆ ಸಾಧಿಸದಿದ್ದರೆ, ನಮಗಿರುವ ಉತ್ತಮ ಅವಕಾಶವನ್ನು ಕಳೆದುಕೊಳ್ಳುತ್ತೇವೆ.
We have to invest more on R & D and focus on enhancing the intellectual capital through radically new approaches which will have to be forward looking and more receptive to adaptation of the best ideas as well as seeking solutions required for our country and global contexts.	ನಾವು ಸಂಶೋಧನೆ ಮತ್ತು ಅಭಿವೃದ್ಧಿಯ ಮೇಲೆ ಹೆಚ್ಚು ಹೂಡಿಕೆ ಮಾಡಬೇಕು ಮತ್ತು ಆಮೂಲಾಗ್ರವಾಗಿ ಹೊಸ ವಿಧಾನಗಳ ಮೂಲಕ ಬೌದ್ಧಿಕ ಬಂಡವಾಳವನ್ನು ಹೆಚ್ಚಿಸುವತ್ತ ಗಮನ ಹರಿಸಬೇಕು ಮತ್ತು ನಮ್ಮ ದೇಶ ಮತ್ತು ಜಾಗತಿಕ ಸಂದರ್ಭಗಳಿಗೆ ಅಗತ್ಯವಾದ ಪರಿಹಾರಗಳನ್ನು ಹುಡುಕಬೇಕು .
As the Prime Minister, ShriNarendraModi had stated the other day, the mantra should beInnovate, Patent, Produce and Prosper.	ಪ್ರಧಾನ ಮಂತ್ರಿ ಶ್ರೀ ನರೇಂದ್ರ ಮೋದಿ ಅವರು ಹೇಳಿದಂತೆ,ಆವಿಷ್ಕರಿಸು, ಪೇಟೆಂಟ್ ಪಡೆ, ಉತ್ಪಾದಿಸು ಮತ್ತು ಪ್ರಗತಿ ಕಾಣು   ಎಂಬುದು ಮಂತ್ರವಾಗಿರಬೆಕು.
I also would like to appeal from this forum to the Corporate India to develop a symbiotic partnership with the universities and other academic institutions and contribute towards promoting R & D.	ವಿಶ್ವವಿದ್ಯಾನಿಲಯಗಳು ಮತ್ತು ಇತರ ಶೈಕ್ಷಣಿಕ ಸಂಸ್ಥೆಗಳೊಂದಿಗೆ ಸಹಭಾಗಿತ್ವವನ್ನು ಬೆಳೆಸಲು ಮತ್ತು ಆರ್ & ಡಿ ಅನ್ನು ಉತ್ತೇಜಿಸಲು ಕೊಡುಗೆ ನೀಡಲು ನಾನು ಈ ವೇದಿಕೆಯಿಂದ ಕಾರ್ಪೊರೇಟ್ ಭಾರತಕ್ಕೆ ಮನವಿ ಮಾಡುತ್ತೇನೆ.
The India of today is surging forward with renewed vigour and enthusiasm	ಇಂದಿನ ಭಾರತವು ಹೊಸ ಚೈತನ್ಯ ಮತ್ತು ಉತ್ಸಾಹದಿಂದ ಮುಂದೆ ಸಾಗುತ್ತಿದೆ.
As the country aims to become a $ 5 trillion economy in the coming years, we need to fully leverage the demographic advantage with science and technology playing a leading role in driving the economic and social development	ಮುಂಬರುವ ವರ್ಷಗಳಲ್ಲಿ ದೇಶವು 5 ಟ್ರಿಲಿಯನ್ ಡಾಲರ್ ಆರ್ಥಿಕತೆಯಾಗಲು ಉದ್ದೇಶಿಸಿರುವಂತೆ, ಆರ್ಥಿಕ ಮತ್ತು ಸಾಮಾಜಿಕ ಅಭಿವೃದ್ಧಿಗೆ ಚಾಲನೆ ನೀಡುವಲ್ಲಿ ವಿಜ್ಞಾನ ಮತ್ತು ತಂತ್ರಜ್ಞಾನವು ಪ್ರಮುಖ ಪಾತ್ರ ವಹಿಸುವುದರೊಂದಿಗೆ ನಾವು ಜನಸಂಖ್ಯೆಯ ಪ್ರಯೋಜನವನ್ನು ಸಂಪೂರ್ಣವಾಗಿ ಉಪಯೋಗಿಸಿಕೊಳ್ಳಬೇಕಾಗಿದೆ.
On its part, the government has launched several initiatives like Make in India, Digital India and Start Up India to promote indigenous manufacturing, empower people digitally and wealth-creation through innovation	ಸ್ಥಳೀಯ ಉತ್ಪಾದನೆಯನ್ನು ಉತ್ತೇಜಿಸಲು, ಜನರನ್ನು ಡಿಜಿಟಲ್ ರೂಪದಲ್ಲಿ ಸಬಲೀಕರಣಗೊಳಿಸಲು ಮತ್ತು ಹೊಸತನದ ಮೂಲಕ ಸಂಪತ್ತು ಸೃಷ್ಟಿಸಲು ಸರ್ಕಾರವು ಮೇಕ್ ಇನ್ ಇಂಡಿಯಾ, ಡಿಜಿಟಲ್ ಇಂಡಿಯಾ ಮತ್ತು ಸ್ಟಾರ್ಟ್ ಅಪ್ ಇಂಡಿಯಾದಂತಹ ಉಪಕ್ರಮಗಳನ್ನು ಪ್ರಾರಂಭಿಸಿದೆ.
I am sure, senior scientists would be mentoring and hand-holding the young ones to benefit from such schemes and realize their scientific and entrepreneurial potential.	ಅಂತಹ ಯೋಜನೆಗಳಿಂದ ಲಾಭ ಪಡೆಯಲು ಮತ್ತು ಅವರ ವೈಜ್ಞಾನಿಕ ಮತ್ತು ಉದ್ಯಮಶೀಲತೆಯ ಸಾಮರ್ಥ್ಯವನ್ನು ಅರಿತುಕೊಳ್ಳಲು ಹಿರಿಯ ವಿಜ್ಞಾನಿಗಳು ಯುವಕರಿಗೆ ಮಾರ್ಗದರ್ಶನ ಮಾಡುತ್ತಾರೆ ಮತ್ತು ಅವರ ಕೈ ಹಿಡಿದು ನಡೆಸುತ್ತಾರೆ ಎಂದು ನನಗೆ ನಂಬಿಕೆಯಿದೆ.
I am happy to note that so many scientists have received ISCA Awards, besides Young Scientists Awards, and ISCA Best Poster Awardst is also a memorable event for many of you who have presented papers in this Science Congress	ಯುವ ವಿಜ್ಞಾನಿಗಳ ಪ್ರಶಸ್ತಿಗಳು ಮತ್ತು ಐಎಸ್ಸಿಎ ಅತ್ಯುತ್ತಮ ಪೋಸ್ಟರ್ ಪ್ರಶಸ್ತಿಗಳಲ್ಲದೆ ಅನೇಕ ವಿಜ್ಞಾನಿಗಳು ಐಎಸ್ಸಿಎ ಪ್ರಶಸ್ತಿಗಳನ್ನು ಪಡೆದಿರುವುದು ನನಗೆ ಸಂತಸ ತಂದಿದೆ.
The practice of senior academics and scientists lending a helping hand to juniors in presenting scientific papers is really praise-worthy	ಹಿರಿಯ ಶಿಕ್ಷಣ ತಜ್ಞರು ಮತ್ತು ವಿಜ್ಞಾನಿಗಳು ವೈಜ್ಞಾನಿಕ ಪ್ರಬಂಧಗಳನ್ನು ಪ್ರಸ್ತುತಪಡಿಸುವಲ್ಲಿ ಕಿರಿಯರಿಗೆ ಸಹಾಯ ಹಸ್ತ ನೀಡುವ ಅಭ್ಯಾಸ ನಿಜವಾಗಿಯೂ ಪ್ರಶಂಸೆಗೆ ಅರ್ಹವಾಗಿದೆ.
This practice ensures the growth of the community in a healthy way	ಈ ಅಭ್ಯಾಸವು ಸಮುದಾಯ ಬೆಳವಣಿಗೆ ಆರೋಗ್ಯಕರ ರೀತಿಯಲ್ಲಿರುವುದನ್ನು ಖಾತ್ರಿಗೊಳಿಸುತ್ತದೆ.
A word of appreciation is due to the University of Agricultural Sciences, Bengaluru for hosting the event amidst this sylvan setting.	ಈ ಕಾಡಿನಂತಹ ಪರಿಸರದಲ್ಲಿ ಕಾರ್ಯಕ್ರಮವನ್ನು ಆಯೋಜಿಸಿದ್ದಕ್ಕಾಗಿ ಬೆಂಗಳೂರಿನ ಕೃಷಿ ವಿಜ್ಞಾನ ವಿಶ್ವವಿದ್ಯಾಲಯವು ಮೆಚ್ಚುಗೆಗೆ ಅರ್ಹವಾಗಿದೆ.
I am sure that this event has provided a wonderful learning opportunity for all of you	ಈ ಕಾರ್ಯಕ್ರಮವು ನಿಮ್ಮೆಲ್ಲರಿಗೂ ಅದ್ಭುತವಾದ ಕಲಿಕೆಯ ಅವಕಾಶವನ್ನು ಒದಗಿಸಿದೆ ಎಂದು ನನಗೆ ನಂಬಿಕೆಯಿದೆ.
It is successful if it helps to find solutions that are appropriate to our present day challenges without jeopardizing our collective future.	ನಮ್ಮ ಸಾಮೂಹಿಕ ಭವಿಷ್ಯಕ್ಕೆ ಧಕ್ಕೆ ಬರದಂತೆ ನಮ್ಮ ಇಂದಿನ ಸವಾಲುಗಳಿಗೆ ಸೂಕ್ತವಾದ ಪರಿಹಾರಗಳನ್ನು ಕಂಡುಹಿಡಿಯಲು ಸಹಾಯ ಮಾಡಿದರೆ ಇದು ಯಶಸ್ವಿಯಾದಂತೆಯೇ.
We must deliver good quality education and healthcare	ನಾವು ಉತ್ತಮ ಗುಣಮಟ್ಟದ ಶಿಕ್ಷಣ ಮತ್ತು ಆರೋಗ್ಯ ಸೇವೆಯನ್ನು ನೀಡಬೇಕು.
These are challenges that need innovative thinking and collaborative action	ಹೊಸ ಚಿಂತನೆ ಮತ್ತು ಸಹಕಾರಿ ಕ್ರಿಯೆಯ ಅಗತ್ಯವಿರುವ ಸವಾಲುಗಳು ಇವು.
We live in an interconnected world and we need to learn how to work together to make it a safer, more peaceful and a more sustainable planet.	ನಾವು ಅಂತರ್ಸಂಪರ್ಕಿತ ಜಗತ್ತಿನಲ್ಲಿ ವಾಸಿಸುತ್ತಿದ್ದೇವೆ ಮತ್ತು ಅದನ್ನು ಹೆಚ್ಚು ಸುರಕ್ಷಿತ, ಶಾಂತಿಯುತ ಮತ್ತು ಸುಸ್ಥಿರ ಗ್ರಹವನ್ನಾಗಿ ಮಾಡಲು ಹೇಗೆ ಒಟ್ಟಾಗಿ ಕೆಲಸ ಮಾಡಬೇಕೆಂದು ನಾವು ಕಲಿಯಬೇಕಾಗಿದೆ.
As we begin the new year and a new decade in our countrys history, we must build on our past and build new bridges through science and technology to a brighter future	ನಾವು ಹೊಸ ವರ್ಷ ಮತ್ತು ಹೊಸ ದಶಕವನ್ನು ಪ್ರಾರಂಭಿಸುತ್ತಿರುವಾಗ, ನಾವು ವಿಜ್ಞಾನದ ಮತ್ತು ತಂತ್ರಜ್ಞಾನದ ಮೂಲಕ ನಮ್ಮ ಭೂತಕಾಲ  ಮತ್ತು ಉಜ್ವಲ ಭವಿಷ್ಯಕ್ಕೆ ಹೊಸ ಸೇತುವೆಗಳನ್ನು ನಿರ್ಮಿಸಬೇಕು.
I wish to conclude by quoting again from Boses concluding message which is relevant in todays context as it was in 1917 when his research centre was set up: We stand here today and resume work tomorrow so that by our efforts of our lives and our unshaken faith in the future, we may all help to build the greater India yet to be.	1917 ರಲ್ಲಿ ಅವರ ಸಂಶೋಧನಾ ಕೇಂದ್ರದ ಸ್ಥಾಪನೆಯ ದಿನ ಬೋಸ್‌ ಮಾಡಿದ ಮುಕ್ತಾಯದ ಸಂದೇಶವನ್ನು ಮತ್ತೊಮ್ಮೆ ಉಲ್ಲೇಖಿಸುವ ಮೂಲಕ ನಾನು ನನ್ನ ಮಾತು ಮುಕ್ತಾಯಗೊಳಿಸಲು ಬಯಸುತ್ತೇನೆ: “ನಾವು ಇಂದು ಇಲ್ಲಿ ನಿಂತು ನಾಳೆಯ ಕೆಲಸವನ್ನು ಪುನರಾರಂಭಿಸುತ್ತೇವೆ.
Cabinet approves agreement between India and Mongolia on Cooperation in the Exploration and Uses of Outer Space for Peaceful and Civilian Purposes	ಶಾಂತಿಯುತ ಮತ್ತು ನಾಗರಿಕ ಉದ್ದೇಶಗಳಿಗಾಗಿ ಬಾಹ್ಯಾಕಾಶ ಪರಿಶೋಧನೆ ಮತ್ತು ಬಳಕೆಯಲ್ಲಿ ಸಹಕಾರ ಕುರಿತು ಭಾರತ ಮತ್ತು ಮಂಗೋಲಿಯಾ ನಡುವಿನ ಒಪ್ಪಂದಕ್ಕೆ ಸಂಪುಟದ ಅನುಮೋದನೆ
The Union Cabinet, chaired by the Prime Minister Shri Narendra Modi, has given its approval for an Agreement between Government of the Republic of India and Government of Mongolia on Cooperation in the Exploration and Uses of Outer Space for Peaceful and Civilian Purposes.	ಪ್ರಧಾನಿ ಶ್ರೀ ನರೇಂದ್ರ ಮೋದಿ ಅವರ ಅಧ್ಯಕ್ಷತೆಯಲ್ಲಿ ನಡೆದ ಕೇಂದ್ರ ಸಚಿವ ಸಂಪುಟ ಸಭೆಯು, ಶಾಂತಿಯುತ ಮತ್ತು ನಾಗರಿಕ ಉದ್ದೇಶಗಳಿಗಾಗಿ ಬಾಹ್ಯಾಕಾಶ ಪರಿಶೋಧನೆ ಮತ್ತು ಬಳಕೆಗಳಲ್ಲಿ ಸಹಕಾರ ಕುರಿತು ಭಾರತ ಮತ್ತು ಮಂಗೋಲಿಯಾ ಸರ್ಕಾರದ ನಡುವಿನ ಒಪ್ಪಂದಕ್ಕೆ ಅನುಮೋದನೆ ನೀಡಿದೆ.
The Agreement was signed at New Delhi on 20 September 2019 during the state visit of the President of Mongolia to India.	ಮಂಗೋಲಿಯಾ ಅಧ್ಯಕ್ಷರ ಭಾರತ ಪ್ರವಾಸದ ಸಂದರ್ಭದಲ್ಲಿ ಸೆಪ್ಟೆಂಬರ್ 20, 2019 ರಂದು ನವದೆಹಲಿಯಲ್ಲಿ ಈ ಒಪ್ಪಂದಕ್ಕೆ ಸಹಿ ಹಾಕಲಾಗಿತ್ತು.
This Agreement shall enable pursuing the following potential interest areas of cooperation such as, space science, technology and applications including remote sensing of the earthatellite communication and satellite based navigationpace science and planetary explorationse of spacecraft and space systems and ground systemnd application of space technology.	ಈ ಒಪ್ಪಂದವು ಬಾಹ್ಯಾಕಾಶ ವಿಜ್ಞಾನ, ತಂತ್ರಜ್ಞಾನ ಮತ್ತು ಭೂಮಿಯ ದೂರ ಸಂವೇದನೆ ಪಗ್ರಹ ಸಂವಹನ ಮತ್ತು ಉಪಗ್ರಹ ಆಧಾರಿತ ಸಂಚರಣೆ ಾಹ್ಯಾಕಾಶ ವಿಜ್ಞಾನ ಮತ್ತು ಗ್ರಹಗಳ ಪರಿಶೋಧನೆ ಾಹ್ಯಾಕಾಶ ನೌಕೆ ಮತ್ತು ಬಾಹ್ಯಾಕಾಶ ವ್ಯವಸ್ಥೆಗಳು ಮತ್ತು ನೆಲದ ವ್ಯವಸ್ಥೆಯ ಬಳಕೆ ಮತ್ತು ಬಾಹ್ಯಾಕಾಶ ತಂತ್ರಜ್ಞಾನದ ಅಪ್ಲಿಕೇಶನ್‌ಗಳಂತಹ ಸಹಕಾರದ ಸಂಭಾವ್ಯ ಆಸಕ್ತಿಯ ಕ್ಷೇತ್ರಗಳನ್ನು ಅನುಸರಿಸಲು ಅನುವು ಮಾಡಿಕೊಡುತ್ತದೆ.
Thus all sections and regions of the country will get benefited.	ಹೀಗಾಗಿ ದೇಶದ ಎಲ್ಲಾ ಭಾಗಗಳು ಮತ್ತು ಪ್ರದೇಶಗಳು ಇದರ ಪ್ರಯೋಜನ ಪಡೆಯುತ್ತವೆ.
Implementation Strategy and targets	ಅನುಷ್ಠಾನ ತಂತ್ರ ಮತ್ತು ಗುರಿಗಳು
The signed Agreement would lead to concluding specific implementing Arrangement and setting up of Joint Working Group, to work out the plan of action including the time-frame and the means of implementing this Agreement.	ಒಪ್ಪಂದವು ನಿರ್ದಿಷ್ಟ ಅನುಷ್ಠಾನ ವ್ಯವಸ್ಥೆಯನ್ನು ತೀರ್ಮಾನಿಸಲು ಮತ್ತು ಜಂಟಿ ಕಾರ್ಯ ಸಮೂಹವನ್ನು ಸ್ಥಾಪಿಸಲು, ಸಮಯದ-ಚೌಕಟ್ಟು ಮತ್ತು ಈ ಒಪ್ಪಂದವನ್ನು ಅನುಷ್ಠಾನಗೊಳಿಸುವ ವಿಧಾನಗಳು ಸೇರಿದಂತೆ ಕ್ರಿಯಾ ಯೋಜನೆಯನ್ನು ರೂಪಿಸಲು ಕಾರಣವಾಗುತ್ತದೆ.
The signed Agreement will provide impetus to explore newer research activities and application possibilities in the field of remote sensing of the earthatellite communicationatellite navigationpace science and exploration of outer space.	ಭೂಮಿಯ ದೂರ ಸಂವೇದಿ, ಉಪಗ್ರಹ ಸಂವಹನ, ಉಪಗ್ರಹ ಸಂಚರಣೆ, ಬಾಹ್ಯಾಕಾಶ ವಿಜ್ಞಾನ ಮತ್ತು ಬಾಹ್ಯಾಕಾಶ ಪರಿಶೋಧನೆ ಕ್ಷೇತ್ರದಲ್ಲಿ ಹೊಸ ಸಂಶೋಧನಾ ಚಟುವಟಿಕೆಗಳು ಮತ್ತು ಅಪ್ಲಿಕೇಶನ್ ಸಾಧ್ಯತೆಗಳನ್ನು ಅನ್ವೇಷಿಸಲು ಒಪ್ಪಂದವು ಉತ್ತೇಜಿಸುತ್ತದೆ.
Department of Space (DOS) and the Mongolian Ministry of Infrastructure signed an Agreement for cooperation in space science, technology and applications on January 15, 2004	ಬಾಹ್ಯಾಕಾಶ ಇಲಾಖೆ ಮತ್ತು ಮಂಗೋಲಿಯನ್ ಮೂಲಸೌಕರ್ಯ ಸಚಿವಾಲಯವು ಜನವರಿ 15, 2004 ರಂದುಬಾಹ್ಯಾಕಾಶ ವಿಜ್ಞಾನ, ತಂತ್ರಜ್ಞಾನ ಮತ್ತು ಅನ್ವಯಿಕೆಗಳಲ್ಲಿ ಸಹಕಾರಕ್ಕಾಗಿ ಒಪ್ಪಂದಕ್ಕೆಸಹಿ ಹಾಕಿತು.
When our Embassy in Mongolia was contacted for reviving the cooperation, it is understood that Mongolian Ministry of Infrastructure is abolished and the space activities are presently handled by Communication and Information Technology Authority (CITA) of Mongolia.	ಸಹಕಾರವನ್ನು ಪುನರುಜ್ಜೀವನಗೊಳಿಸಲು ಮಂಗೋಲಿಯಾದ ನಮ್ಮ ರಾಯಭಾರ ಕಚೇರಿಯನ್ನು ಸಂಪರ್ಕಿಸಿದಾಗ, ಮಂಗೋಲಿಯನ್ ಮೂಲಸೌಕರ್ಯ ಸಚಿವಾಲಯವನ್ನು ರದ್ದುಪಡಿಸಲಾಗಿದ್ದು, ಬಾಹ್ಯಾಕಾಶ ಚಟುವಟಿಕೆಗಳನ್ನು ಪ್ರಸ್ತುತ ಮಂಗೋಲಿಯಾದ ಸಂವಹನ ಮತ್ತು ಮಾಹಿತಿ ತಂತ್ರಜ್ಞಾನ ಪ್ರಾಧಿಕಾರ (ಸಿಐಟಿಎ) ನಿರ್ವಹಿಸುತ್ತಿದೆ ಎಂದು ತಿಳಿದುಬಂದಿದೆ.
Cabinet approves ratification of Migration and Mobility Partnership Agreement between India and France	ಭಾರತ ಮತ್ತು ಫ್ರಾನ್ಸ್ ನಡುವಿನ ವಲಸೆ ಮತ್ತು ಸಂಚಾರ ಪಾಲುದಾರಿಕೆ ಒಪ್ಪಂದಕ್ಕೆ ಸಂಪುಟದ ಅನುಮೋದನೆ
The Agreement was signed in March, 2018 during the State Visit of the French President to India	ಫ್ರೆಂಚ್ ಅಧ್ಯಕ್ಷರ ಭಾರತ ಭೇಟಿಯ ಸಂದರ್ಭದಲ್ಲಿ ಮಾರ್ಚ್, 2018 ರಲ್ಲಿ ಈ ಒಪ್ಪಂದಕ್ಕೆ ಸಹಿ ಹಾಕಲಾಗಿತ್ತು.
The Agreement represents a major milestone in enhancing people-to-people contacts, fostering mobility of students, academics, researchers and skilled professionals and strengthening cooperation on issues related to irregular migration and human trafficking between the two sides	ಈ ಒಪ್ಪಂದವು ಜನರ ನಡುವಿನ ಸಂಪರ್ಕಗಳನ್ನು ಹೆಚ್ಚಿಸುವಲ್ಲಿ, ವಿದ್ಯಾರ್ಥಿಗಳು, ಶಿಕ್ಷಣ ತಜ್ಞರು, ಸಂಶೋಧಕರು ಮತ್ತು ನುರಿತ ವೃತ್ತಿಪರರ ಸಂಚಾರವನ್ನು ಹೆಚ್ಚಿಸುವಲ್ಲಿ ಮತ್ತು ಎರಡೂ ಕಡೆಯ ಅನಿಯಮಿತ ವಲಸೆ ಮತ್ತು ಮಾನವ ಕಳ್ಳಸಾಗಣೆಗೆ ಸಂಬಂಧಿಸಿದ ವಿಷಯಗಳ ಬಗ್ಗೆ ಸಹಕಾರವನ್ನು ಬಲಪಡಿಸುವ ಪ್ರಮುಖ ಮೈಲಿಗಲ್ಲಾಗಿದೆ.
Cabinet approves Memorandum of Understanding between India and Sweden on cooperation in Polar Science	ಧ್ರುವ ವಿಜ್ಞಾನದಲ್ಲಿ ಸಹಕಾರ ಕುರಿತ ಭಾರತ ಮತ್ತು ಸ್ವೀಡನ್ ನಡುವಿನ ತಿಳುವಳಿಕೆ ಒಪ್ಪಂದಕ್ಕೆ ಸಂಪುಟದ  ಅಂಗೀಕಾರ
The Union Cabinet, chaired by the Prime Minister Shri Narendra Modi, has been apprised of the Agreement on cooperation in polar science between Ministry of Earth Sciences (MoES), India and Ministry of Education and Research, Sweden	ಪ್ರಧಾನಿ ಶ್ರೀ ನರೇಂದ್ರ ಮೋದಿ ಅವರ ಅಧ್ಯಕ್ಷತೆಯಲ್ಲಿ ನಡೆದ ಕೇಂದ್ರ ಸಚಿವ ಸಂಪುಟ ಸಭೆಯು, ಭಾರತದ ಭೂ ವಿಜ್ಞಾನ ಸಚಿವಾಲಯ (ಎಂಒಇಎಸ್) ಮತ್ತು ಸ್ವೀಡನ್‌ನ ಶಿಕ್ಷಣ ಮತ್ತು ಸಂಶೋಧನಾ ಸಚಿವಾಲಯದ ನಡುವಿನ ಧ್ರುವ ವಿಜ್ಞಾನದ ಸಹಕಾರ ಒಪ್ಪಂದಕ್ಕೆ ಅಂಗೀಕಾರ ನೀಡಿದೆ.
The Memorandum of Understanding (MoU) was signed on 2nd December 2019 during the visit of Their Majesties of the Kingdom of Sweden to India.	ಸ್ವೀಡನ್ ದೊರೆಯ ಭಾರತ ಭೇಟಿ ಸಂದರ್ಭದಲ್ಲಿ 2019 ರ ಡಿಸೆಂಬರ್ 2 ರಂದು ತಿಳುವಳಿಕೆ ಪತ್ರಕ್ಕೆ ಸಹಿ ಹಾಕಲಾಗಿತ್ತು.
Sweden has a vigorous scientific program in the Polar Regions, both in Arctic and Antarctic	ಧ್ರುವ ಪ್ರದೇಶಗಳಲ್ಲಿ ಆರ್ಕ್ಟಿಕ್ ಮತ್ತು ಅಂಟಾರ್ಕ್ಟಿಕ್ ಎರಡರಲ್ಲೂ ಸ್ವೀಡನ್ ಹುರುಪಿನ ವೈಜ್ಞಾನಿಕ ಕಾರ್ಯಕ್ರಮವನ್ನು ಹೊಂದಿದೆ.
India likewise, has sustained scientific research programs in both the Polar Regions as well as in the oceanic realm.	ಅದೇ ರೀತಿ  ಭಾರತವೂ ಸಹ  ಧ್ರುವ ಪ್ರದೇಶಗಳಲ್ಲಿ ಮತ್ತು ಸಾಗರ ಕ್ಷೇತ್ರದಲ್ಲಿ ವೈಜ್ಞಾನಿಕ ಸಂಶೋಧನಾ ಕಾರ್ಯಕ್ರಮಗಳನ್ನು ನಡೆಸುತ್ತಿದೆ.
The collaboration between India and Sweden in polar science will enable sharing of the expertise available with both Countries.	ಭಾರತ ಮತ್ತು ಸ್ವೀಡನ್ ನಡುವಿನ ಧ್ರುವ ವಿಜ್ಞಾನದ ಸಹಯೋಗವು ಎರಡೂ ದೇಶಗಳು ಲಭ್ಯವಿರುವ ಪರಿಣತಿಯನ್ನು ಪರಸ್ಪರ ಹಂಚಿಕೊಳ್ಳಲು ಅನುವು ಮಾಡಿಕೊಡುತ್ತದೆ.
Cabinet apprised of information about amendments to the Motor Vehicles (Amendment) Bill, 2019	ಮೋಟಾರು ವಾಹನಗಳ (ತಿದ್ದುಪಡಿ) ಮಸೂದೆ, 2019 ರ ತಿದ್ದುಪಡಿಗಳ ಮಾಹಿತಿಗೆ ಸಂಪುಟದ ಅನುಮೋದನೆ
The Union Cabinet, chaired by the Prime Minister Shri Narendra Modi, has been apprised of information about the amendments moved to the Motor Vehicles (Amendment) Bill, 2019 as passed by the Rajya Sabha	ಪ್ರಧಾನಿ ಶ್ರೀ ನರೇಂದ್ರ ಮೋದಿ ಅವರ ಅಧ್ಯಕ್ಷತೆಯಲ್ಲಿ ನಡೆದ ಕೇಂದ್ರ ಸಚಿವ ಸಂಪುಟ ಸಭೆಯು, ರಾಜ್ಯಸಭೆ ಅಂಗೀಕರಿಸಿದ 2019 ರ ಮೋಟಾರು ವಾಹನಗಳ (ತಿದ್ದುಪಡಿ) ಮಸೂದೆಗೆ ತರಲಾಗಿರುವ ತಿದ್ದುಪಡಿಗಳ ಬಗೆಗಿನ ಮಾಹಿತಿಗೆ ಅನುಮೋದನೆ ನೀಡಿದೆ.
Amendments will ensure concurrence of the State Governments while formulating National Transport Policy and making schemes for national, multimodal and inter-state transportation of goods and passengers by the Central Government	ಈ ತಿದ್ದುಪಡಿಗಳಿಂದಾಗಿ, ರಾಷ್ಟ್ರೀಯ ಸಾರಿಗೆ ನೀತಿಯನ್ನು ರೂಪಿಸುವಾಗ ಮತ್ತು ಕೇಂದ್ರ ಸರ್ಕಾರದಿಂದ ಸರಕು ಮತ್ತು ಪ್ರಯಾಣಿಕರ ರಾಷ್ಟ್ರೀಯ, ಮಲ್ಟಿಮೋಡಲ್ ಮತ್ತು ಅಂತರರಾಜ್ಯ ಸಾಗಣೆಗೆ ಯೋಜನೆಗಳನ್ನು ರೂಪಿಸುವಾಗ ರಾಜ್ಯ ಸರ್ಕಾರಗಳ ಸಮ್ಮತಿಯನ್ನು ಖಚಿತಪಡಿಸುತ್ತದೆ.
The Motor Vehicles (Amendment) Bill, 2019 was approved by the Cabinet in its meeting held on 24th June, 2019 for re-introduction in the Lok Sabha	ಮೋಟಾರು ವಾಹನ (ತಿದ್ದುಪಡಿ) ಮಸೂದೆ, 2019 ನ್ನು ಲೋಕಸಭೆಯಲ್ಲಿ ಮರು ಮಂಡನೆಗಾಗಿ 2019 ರ ಜೂನ್ 24 ರಂದು ಸಂಉಟ ಸಭೆಯು ಅನುಮೋದನೆ ನೀಡಿತ್ತು.
The Motor Vehicles (Amendment) Bill, 2019 was passed in the Lok Sabha on 23rd July, 2019	ಮೋಟಾರು ವಾಹನಗಳ (ತಿದ್ದುಪಡಿ) ಮಸೂದೆಯು, 2019 ರ ಜುಲೈ 23 ರಂದು ಲೋಕಸಭೆಯಲ್ಲಿ ಅಂಗೀಕರಿಸಲ್ಪಟ್ಟಿತು.
Later, the Bill was taken into consideration in Rajya Sabha on 31st July, 2019	ನಂತರ, ಈ ಮಸೂದೆಯನ್ನು ರಾಜ್ಯಸಭೆಯಲ್ಲಿ 2019 ರ ಜುಲೈ 31 ರಂದು ಮಂಡಿಸಲಾಯಿತು.
The Bill with the official amendments was passed by the Rajya Sabha on 31st July, 2019	31 ಜುಲೈ, 2019 ರಂದು ತಿದ್ದುಪಡಿಗಳೊಂದಿಗೆ ಮಸೂದೆಯನ್ನು ರಾಜ್ಯಸಭೆಯು ಅಂಗೀಕರಿಸಿತು.
Further, the amendments were placed before the Lok Sabha and were passed in the Lok Sabha on 5th August, 2019	ಇದಲ್ಲದೆ, ತಿದ್ದುಪಡಿಗಳನ್ನು ಲೋಕಸಭೆಯ ಮುಂದೆ ಪ್ರಸ್ತಾಪಿಸಲಾಯಿತು ಮತ್ತು 2019 ರ ಆಗಸ್ಟ್ 5 ರಂದು ಲೋಕಸಭೆಯಲ್ಲಿ ಅಂಗೀಕರಿಸಲಾಯಿತು.
Ministry of Road Transport & Highways	ರಸ್ತೆ ಸಾರಿಗೆ ಮತ್ತು ಹೆದ್ದಾರಿ ಸಚಿವಾಲಯ
Cabinet approves conferring the status of institution of national importance to the cluster of ayurveda institutions at Gujarat Ayurved University campus, Jamnagar	ಜಾಮ್ ನಗರದ ಗುಜರಾತ್ ಆಯುರ್ವೇದ ವಿಶ್ವ ವಿದ್ಯಾಲಯದ ಆಯುರ್ವೇದ ಸಂಸ್ಥೆಗಳ ಸಮೂಹಕ್ಕೆ ರಾಷ್ಟ್ರೀಯ ಪ್ರಾಮುಖ್ಯತೆಯ ಸ್ಥಾನಮಾನ ನೀಡುವ ಕುರಿತು ಸಚಿವ ಸಂಪುಟ ಅನುಮೋದನೆ
The Union Cabinet, chaired by the Prime Minister Shri Narendra Modi, has given its approvalto confer the status of Institution of National Importance to the Institute of Teaching and Research in Ayurveda Jamnagar by conglomerating the cluster of Ayurveda Institutes at Gujarat Ayurveda University campus, Jamnagar , namely, (a) Institute for Post Graduate Teaching and Research in Ayurveda (b) Shri Gulabkunwerba Ayurveda Mahavidyalaya and	ಜಾಮ್ ನಗರದ ಗುಜರಾತ್ ಆಯುರ್ವೇದ ವಿಶ್ವವಿದ್ಯಾಲಯದಲ್ಲಿರುವ  ಆಯುರ್ವೇದ ಸಂಸ್ಥೆಗಳ ಸಮೂಹವನ್ನು ಒಗ್ಗೂಡಿಸುವ ಮೂಲಕ ಜಾಮ್ ನಗರದ ಆಯುರ್ವೇದ ಕಲಿಕೆ ಮತ್ತು ಸಂಶೋಧನೆ ಸಂಸ್ಥೆಗೆ ರಾಷ್ಟ್ರೀಯ ಮಾನ್ಯತೆಯನ್ನು ನೀಡಲು ಪ್ರಧಾನ ಮಂತ್ರಿಗಳಾದ ಶ್ರೀ ನರೇಂದ್ರ ಮೋದಿಯವರ ಅಧ್ಯಕ್ಷತೆಯಲ್ಲಿರುವ ಕೇಂದ್ರ ಸಚಿವ ಸಂಪುಟ ಅನುಮೋದನೆ ನೀಡಿದೆ.
The Bill to that effect is to be introduced in the ensuing Session of Parliament to declare Institute of Teaching and Research in Ayurveda, Jamnagar as Institution of National Importance.	ಜಾಮ್ ನಗರದ ಆಯುರ್ವೇದ ಕಲಿಕೆ ಮತ್ತು ಸಂಶೋಧನೆ ಸಂಸ್ಥೆಯನ್ನು ರಾಷ್ಟ್ರೀಯ ಪ್ರಾಮುಖ್ಯತೆಯ ಸಂಸ್ಥೆಯನ್ನಾಗಿ ಘೋಷಿಸಲು ಮುಂಬರುವ ಸಂಸತ್ತಿನ ಅಧಿವೇಶನದಲ್ಲಿ ಈ ಮಸೂದೆಯನ್ನು ಮಂಡಿಸಲಾಗುವುದು.
Considering the rapidly growing role of AYUSH Systems in addressing the Public Health challenges of India, conferring the status of National Importance will boost the role and importance of Ayurveda in Public Health	ಭಾರತದ ಸಾರ್ವಜನಿಕ ಆರೋಗ್ಯ ಸಮಸ್ಯೆಗಳನ್ನು ಎದುರಿಸುವಲ್ಲಿ ಆಯುಷ್ ಪದ್ಧತಿಗಳ ಪಾತ್ರ ತೀವ್ರವಾಗಿ ವೃದ್ಧಿಸುತ್ತಿರುವುದನ್ನು ಪರಿಗಣಿಸಿ ರಾಷ್ಟ್ರೀಯ ಪ್ರಾಮುಖ್ಯತೆಯ ಸ್ಥಾನಮಾನ ನೀಡುವುದು ಸಾರ್ವಜನಿಕ ಆರೋಗ್ಯ ರಕ್ಷಣೆಯಲ್ಲಿ ಆಯುರ್ವೇದದ ಪಾತ್ರ ಮತ್ತು ಮಹತ್ವಕ್ಕೆ ಮತ್ತಷ್ಟು ಪುಷ್ಟಿ ದೊರೆಯಲಿದೆ.
There is rising interest and demand for knowledge and services of Ayurveda all over the world	ವಿಶ್ವಾದ್ಯಂತ ಆಯುರ್ವೇದ ಸೇವೆಗಳು ಮತ್ತು ಜ್ಞಾನದ ಕುರಿತು ಆಸಕ್ತಿ ಮತ್ತು ಬೇಡಿಕೆ ಹೆಚ್ಚಿದೆ.
Cabinet gave ex-post-facto approval on the Memorandum of Cooperation between India and Bill & Melinda Gates Foundation (BMGF) on cooperation in the field of Health	ಆರೋಗ್ಯ ಕ್ಷೇತ್ರದಲ್ಲಿ ಸಹಕಾರ ಕುರಿತ ಭಾರತ ಹಾಗು ಬಿಲ್ & ಮೆಲಿಂಡಾ ಗೇಟ್ಸ್ ಫೌಂಡೇಶನ್ (ಬಿಎಂಜಿಎಫ್) ನಡುವಿನ ಸಹಕಾರ ಒಪ್ಪಂದಕ್ಕೆ ಸಂಪುಟದ ಪೂರ್ವಾನ್ವಯ ಅನುಮೋದನೆ
The Union Cabinet, chaired by the Prime Minister Shri Narendra Modi, has given its ex-post-facto approval on the Memorandum of Cooperation (MoC) between Department of Health & Family Welfare (DOHFW), Government of India and Bill & Melinda Gates Foundation (BMGF) on cooperation in the field of Health signed in November, 2019 during the visit of Mrll Gates, Co-Chair and Trustee of BMGF to Delhi.	ಪ್ರಧಾನಿ ಶ್ರೀ ನರೇಂದ್ರ ಮೋದಿ ಅವರ ಅಧ್ಯಕ್ಷತೆಯಲ್ಲಿ ನಡೆದ ಕೇಂದ್ರ ಸಚಿವ ಸಂಪುಟ ಸಭೆಯು, ಭಾರತ ಸರ್ಕಾರದ ಆರೋಗ್ಯ ಮತ್ತು ಕುಟುಂಬ ಕಲ್ಯಾಣ ಇಲಾಖೆ (ಡಿಒಹೆಚ್‌ಡಬ್ಲ್ಯು) ಹಾಗು ಬಿಲ್ & ಮೆಲಿಂಡಾ ಗೇಟ್ಸ್ ಫೌಂಡೇಶನ್ (ಬಿಎಂಜಿಎಫ್) ನಡುವಿನ ಸಹಕಾರ ಒಪ್ಪಂದಕ್ಕೆ (ಎಂಒಸಿ) ಪೂರ್ವಾನ್ವಯ ಅನುಮೋದನೆ ನೀಡಿದೆ.
The Memorandum of Cooperation (MoC) covers the following areas of cooperation:-	ಸಹಕಾರ ಒಪ್ಪಂದ (ಎಂಒಸಿ) ಈ ಕೆಳಗಿನ ಸಹಕಾರ ಕ್ಷೇತ್ರಗಳನ್ನು ಒಳಗೊಂಡಿದೆ
To reduce maternal, neonatal and child morbidity and mortality, improve key nutrition outcomes, by improving the reach, coverage and quality of essential primary health, immunization and nutrition services.	ಎ) ತಾಯಂದಿರು, ನವಜಾತ ಶಿಶುಗಳು ಮತ್ತು ಮಕ್ಕಳ ಕಾಯಿಲೆ ಮತ್ತು ಮರಣ ಪ್ರಮಾಣವನ್ನು ತಗ್ಗಿಸಲು, ಅಗತ್ಯ ಪ್ರಾಥಮಿಕ ಆರೋಗ್ಯ, ರೋಗನಿರೋಧಕ ಮತ್ತು ಪೌಷ್ಠಿಕಾಂಶ ಸೇವೆಗಳ ವ್ಯಾಪ್ತಿ ಮತ್ತು ಗುಣಮಟ್ಟವನ್ನು ವಿಸ್ತರಿಸುವ ಮೂಲಕ ಪ್ರಮುಖ ಪೌಷ್ಟಿಕಾಂಶದ ಫಲಿತಾಂಶಗಳನ್ನು ಸುಧಾರಿಸುವುದು.
To increase the basket of choice and quality for family planning methods, specially for reversible methods, and increase access amongst younger women.	ಬಿ) ಕುಟುಂಬ ಯೋಜನೆ ವಿಧಾನಗಳಿಗೆ, ವಿಶೇಷವಾಗಿ ತಿರಿಗುಮುರುಗು ಮಾಡಬಲ್ಲ ವಿಧಾನಗಳಿಗಾಗಿ ಆಯ್ಕೆ ಮತ್ತು ಗುಣಮಟ್ಟದ ಅವಕಾಶಗಳನ್ನು ಹೆಚ್ಚಿಸುವುದು ಮತ್ತು ಕಡಿಮೆ ವಯಸ್ಸಿನ ಮಹಿಳೆಯರಿಗೆ ಲಭ್ಯತೆಯನ್ನು ಹೆಚ್ಚಿಸುವುದು.
To reduce the burden of select infectious diseases [TB, Visceral Leishmaniasis	ಸಿ) ಆಯ್ದ ಸಾಂಕ್ರಾಮಿಕ ರೋಗಗಳ ಹೊರೆ ಕಡಿಮೆ ಮಾಡುವುದು [ಕ್ಷಯ, ವಿಸ್ಕರಲ್ ಲೀಶ್ಮೇನಿಯಾಸಿಸ್ (ವಿಎಲ್), ದುಗ್ಧರಸ ಫಿಲೇರಿಯಾಸಿಸ್ (ಎಲ್ಎಫ್)].
To strengthen health systems, including aspects such as budget utilization, management and skills of human resources for health, digital health, strengthening supply chains and monitoring systems.	ಡಿ) ಆರೋಗ್ಯ, ಡಿಜಿಟಲ್ ಆರೋಗ್ಯ, ಪೂರೈಕೆ ಸರಪಳಿಯನ್ನು ಬಲಪಡಿಸುವುದು ಮತ್ತು ಮೇಲ್ವಿಚಾರಣಾ ವ್ಯವಸ್ಥೆಗಳಿಗಾಗಿ ಬಜೆಟ್ ಬಳಕೆ, ನಿರ್ವಹಣೆ ಮತ್ತು ಮಾನವ ಸಂಪನ್ಮೂಲಗಳ ಕೌಶಲ್ಯಗಳು ಸೇರಿದಂತೆ ಆರೋಗ್ಯ ವ್ಯವಸ್ಥೆಗಳನ್ನು ಬಲಪಡಿಸುವುದು.
A Program Action Committee (PAC) will be set up to further elaborate the details of cooperation and to oversee the implementation of this Memorandum of Cooperation.	ಸಹಕಾರದ ವಿವರಗಳನ್ನು ಇನ್ನಷ್ಟು ವಿಸ್ತರಿಸಲು ಮತ್ತು ಈ ಸಹಕಾರ ಒಪ್ಪಂದ ಅನುಷ್ಠಾನದ ಮೇಲ್ವಿಚಾರಣೆಗೆ ಕಾರ್ಯಕ್ರಮ ಕ್ರಿಯಾ ಸಮಿತಿಯನ್ನು (ಪಿಎಸಿ) ರಚಿಸಲಾಗುವುದು.
Ministry of Health and Family Welfare	ಆರೋಗ್ಯ ಮತ್ತು ಕುಟುಂಬ ಕಲ್ಯಾಣ ಸಚಿವಾಲಯ
Cabinet approves Memorandum of Understanding between India and United Kingdom for Enabling Energy Self Sufficiency for Indian Railways	ಭಾರತೀಯ ರೈಲ್ವೆಯ ಇಂಧನ ಸ್ವಾವಲಂಬನೆ ಸಾಧನೆಗೆ ಭಾರತ ಮತ್ತು ಬ್ರಿಟನ್  ತಿಳುವಳಿಕೆ ಒಡಂಬಡಿಕೆಗೆ ಸಚಿವ ಸಂಪುಟ ಅನುಮೋದನೆ
The Union Cabinet, chaired by the Prime Minister Shri Narendra Modi, has given its approval forsigning a Memorandum of Understanding (MoU) with the Department for International Development (Government of United Kingdom) on 0219 for Enabling Energy Self-Sufficiency for Indian Railways.	ಭಾರತೀಯ ರೈಲ್ವೇ ಇಂಧನ ಸ್ವಾವಲಂಬನೆ ಹೊಂದಲು ಡಿಸೆಂಬರ್ 2, 2019 ರ ಅಂತಾರಾಷ್ಟ್ರೀಯ ಅಭಿವೃದ್ಧಿ ಇಲಾಖೆ (ಬ್ರಿಟನ್ ಸರ್ಕಾರ) ಜೊತೆ ಭಾರತ ತಿಳುವಳಿಕೆ ಒಡಂಬಡಿಕೆಗೆ ಪ್ರಧಾನಿ ಶ್ರೀ ನರೇಂದ್ರ ಮೋದಿ ಅವರ ಅಧ್ಯಕ್ಷತೆಯಲ್ಲಿ ನಡೆದ ಸಚಿವ ಸಂಪುಟ ಸಭೆ ಅನುಮೋದನೆ ನೀಡಿದೆ.
Implementation Strategy and targets	ಅನುಷ್ಠಾನ ನೀತಿ ಮತ್ತು ಗುರಿಗಳು
ahe Parties agree on the scope of activities to be undertaken as a part of the endeavor for enabling energy efficiency and energy self-sufficiency for the Indian Railways	ಭಾರತೀಯ ರೈಲ್ವೇ ಇಂಧನ ದಕ್ಷತೆ ಮತ್ತು ಇಂಧನ ಸ್ವಾವಲಂಬನೆ ಸಾಧಿಸಲು ಅನುವು ಮಾಡಿಕೊಡುವ ಪ್ರಯತ್ನಗಳ ಅಂಗವಾಗಿ ಕೈಗೊಳ್ಳಬೇಕಾದ ಚಟುವಟಿಕೆಗಳಿಗೆ ಉಭಯ ಪಕ್ಷಗಳ ಅಂಗೀಕಾರ
bach Participant will, subject to the laws, rules, regulations and national policies fromtime to time in force governing the subject matter in their respective countries, endeavour to take necessary steps to enable energy efficiency and energy self-sufficiency for Indian Railways	ಉಭಯ ದೇಶಗಳು ಅವರವರ ದೇಶದ ಕಾನೂನುಗಳು, ನಿಯಮಗಳು, ನಿರ್ಭಂಧನೆಗಳು ಮತ್ತು ರಾಷ್ಟ್ರೀಯ ನೀತಿಗಳಿಗೆ ಒಳಪಟ್ಟಿರುತ್ತವೆ ಹಾಗೂ ಭಾರತೀಯ ರೈಲ್ವೇ ಇಂಧನ ದಕ್ಷತೆ ಮತ್ತು ಇಂಧನ ಸ್ವಾವಲಂಬನೆ ಸಾಧಿಸಲು ಕಾಲಕಾಲಕ್ಕೆ ಅವಶ್ಯಕ ಕ್ರಮಗಳನ್ನು ಕೈಗೊಳ್ಳುತ್ತವೆ.
fhis Memorandum of Understanding shall come into force on its signing by the duly authorized representatives of the Parties and any of the Party may terminate this MoU by written communication addressed to the other, in which case, termination of MoU shall take effect six months after receipt of such written communication.	ಉಭಯ ಪಕ್ಷಗಳ ಅಧಿಕೃತ ಪ್ರತಿನಿಧಿಗಳು ಸಹಿ ಹಾಕಿದ ನಂತರ ಈ ಒಪ್ಪಂದವು ಜಾರಿಗೆ ಬರುವುದು ಮತ್ತು ಯಾವುದೇ ಪಕ್ಷ ಲಿಖಿತ ಸಂವಹನದ ಮೂಲಕ ಮತ್ತೊಂದು ಪಕ್ಷಕ್ಕೆ ತಿಳಿಸುವ ಮೂಲಕ ಈ ಒಪ್ಪಂದವನ್ನು ರದ್ದುಪಡಿಸಬಹುದಾಗಿದೆ.
hny dispute or difference between the Parties shall be settled through mutual consultations and negotiations between the participants.	ಉಭಯ ಪಕ್ಷಗಳ ಮಧ್ಯೆ ಯಾವುದೇ ವ್ಯಾಜ್ಯೆ ಅಥವಾ ಭಿನ್ನತೆ ಇದ್ದಲ್ಲಿ ಅವುಗಳನ್ನು ಪರಸ್ಪರ ಸಮಾಲೋಚನೆ ಮತ್ತು ಮಾತುಕತೆ ಮೂಲಕ ಇತ್ಯರ್ಥಪಡಿಸತಕ್ಕದ್ದು
The MoUs/ MoCs facilitate exchange of technical experts, reports and technical documents, training and seminars/workshops focusing on specific technology areas like Renewable Energy and other interactions for knowledge sharing.	ತಾಂತ್ರಿಕ ಪರಿಣಿತರು, ವರದಿಗಳು ಮತ್ತು ತಾಂತ್ರಿಕ ದಾಖಲೆಗಳು, ತರಬೇತಿ ಹಾಗೂ ಪರ್ಯಾಯ ಇಂಧನದಂಥ ಕ್ಷೇತ್ರಗಳಲ್ಲಿ ನಿರ್ದಿಷ್ಟ ತಂತ್ರಜ್ಞಾನದ ಮೇಲೆ ಗಮನ ಕೇಂದ್ರೀಕರಿಸುವ ಕಾರ್ಯಾಗಾರಗಳು ಮತ್ತು ಜ್ಞಾನ ಹಂಚಿಕೆಗೆ ಇತರ ಸಮಾಲೋಚನೆಗಳಿಗೆ ತಿಳುವಳಿಕೆ ಒಡಂಬಡಿಕೆಗೆ ಅವಕಾಶ ಕಲ್ಪಿಸುತ್ತವೆ.
PM invites Ideas and Suggestions for Union Budget 2020	ಕೇಂದ್ರ ಬಜೆಟ್ 2020ರ ಸಲಹೆಗಳಿಗೆ ಪ್ರಧಾನಮಂತ್ರಿ ಅವರಿಂದ ಆಹ್ವಾನ
Prime Minister Shri Narendra Modi invited ideas and suggestions for the Union Budget 2020 onMyGov.	2020ರ ಕೇಂದ್ರ ಬಜೆಟ್ ಹಿನ್ನೆಲೆಯಲ್ಲಿ ಸಲಹೆ ಮತ್ತು ಆಲೋಚನೆಗಳನ್ನು ಪ್ರಧಾನಮಂತ್ರಿ ಶ್ರೀ ನರೇಂದ್ರ ಮೋದಿ ಅವರು ತಮ್ಮ MyGov ೆ ಆಹ್ವಾನಿಸಿದ್ದಾರೆ ಕೇಂದ್ರ ಬಜೆಟ್ 130 ಕೋಟಿ ಭಾರತೀಯರ ಆಕಾಂಕ್ಷೆಗಳನ್ನು ಪ್ರತಿನಿಧಿಸುತ್ತದೆ ಮತ್ತು ಭಾರತದ ಅಭಿವೃದ್ಧಿಗೆ ಮಾರ್ಗಸೂಚಿ ೀಗಾಗಿ ಈ ಸಾಲಿನ ಬಜೆಟ್ ಗಾಗಿ ನೀವೆಲ್ಲರೂ ನಿಮ್ಮ ಸಲಹೆ ಮತ್ತು ಆಲೋಚನೆಗಳನ್ನು MyGovನಲ್ಲಿ ಹಂಚಿಕೊಳ್ಳಿ” ಎಂದು ಅವರು ತಿಳಿಸಿದ್ದಾರೆ arendra Modi
Prime Minister Chairs Meeting with various sectoral groups in a pre-budget exercise	ಪ್ರಧಾನಿಯವರ ಅಧ್ಯಕ್ಷತೆಯಲ್ಲಿ ವಿವಿಧ ವಲಯಗಳ ಮುಖ್ಯಸ್ಥರೊಂದಿಗೆ ಬಜೆಟ್ ಪೂರ್ವ ಸಭೆ
Calls for a focussed effort from all stake holders to achieve the 5 Trillion Dollar Economy	ಐದು ಟ್ರಿಲಿಯನ್ ಡಾಲರ್ ಆರ್ಥಿಕತೆ ಸಾಧನೆಗಾಗಿ ಪಾಲುದಾರರಿಂದ ಕೇಂದ್ರೀಕೃತ ಪ್ರಯತ್ನಕ್ಕಾಗಿ ಕರೆ
Prime Minister Shri Narendra Modi called for a focussed effort from all stakeholders in order to achieve the target of 5 Trillion Dollar Economy in India.	ಭಾರತದಲ್ಲಿ ಐದು ಟ್ರಿಲಿಯನ್ ಡಾಲರ್ ಆರ್ಥಿಕತೆಯ ಗುರಿಯನ್ನು ಸಾಧಿಸುವ ಸಲುವಾಗಿ ಎಲ್ಲಾ ಪಾಲುದಾರರು  ಕೇಂದ್ರೀಕೃತ ಪ್ರಯತ್ನ ಮಾಡಬೇಕು ಎಂದು ಪ್ರಧಾನಿ ಶ್ರೀ ನರೇಂದ್ರ ಮೋದಿ ಕರೆ ನೀಡಿದ್ದಾರೆ.
Prime Minister was interacting with various senior Economists, Private Equity/Venture Capitalists, Business Leaders from Manufacturing, Travel & Tourism, Apparel & FMCG, Analytics, subject experts in the fields of Agriculture, Science & Technology and Finance.	ಬಜೆಟ್ ಪೂರ್ವಭಾವಿಯಾಗಿ ನವದೆಹಲಿಯ ನೀತಿ ಆಯೋಗದಲ್ಲಿ ಇಂದು ಪ್ರಧಾನ ಮಂತ್ರಿಯವರು, ಹಿರಿಯ ಅರ್ಥಶಾಸ್ತ್ರಜ್ಞರು, ಖಾಸಗಿ ಇಕ್ವಿಟಿ/ ವೆಂಚರ್ ಬಂಡವಾಳಗಾರರು, ಉತ್ಪಾದನೆ, ಪ್ರವಾಸೋದ್ಯಮ, ಉಡುಪು ಮತ್ತು ಎಫ್‌ಎಂಸಿಜಿಯ ಉದ್ಯಮಿಗಳು, ವಿಶ್ಲೇಷಣಾಕಾರರು, ಕೃಷಿ, ವಿಜ್ಞಾನ ಮತ್ತು ತಂತ್ರಜ್ಞಾನ ಮತ್ತು ಹಣಕಾಸು ಕ್ಷೇತ್ರಗಳ ವಿಷಯ ತಜ್ಞರೊಂದಿಗೆ ಸಂವಾದ ಸಭೆ ನಡೆಸಿದರು.
Prime Minister said that he was happy that the two hour open discussion has brought to forefront the experience of people on the ground and those working in their respective fields.	ಎರಡು ಗಂಟೆಯ ಮುಕ್ತ ಚರ್ಚೆಯು ಆಯಾ ಕ್ಷೇತ್ರಗಳಲ್ಲಿ ದುಡಿಯುತ್ತಿರುವವರ ಅನುಭವಗಳನ್ನು ಮುಂಚೂಣಿಗೆ ತಂದಿರುವುದಕ್ಕೆ ಸಂತಸವಾಗಿದೆ ಎಂದು ಪ್ರಧಾನಿ ಹೇಳಿದರು.
He said that this would enhance the synergy between policy makers and various stakeholders.	ಇದು ನೀತಿ ನಿರೂಪಕರು ಮತ್ತು ವಿವಿಧ ಪಾಲುದಾರರ ನಡುವಿನ ಸಮನ್ವಯ ಹೆಚ್ಚಿಸುತ್ತದೆ.
He said that the strong absorbent capacity of Indian economy shows the strength of basic fundamentals of the Indian economy and its capacity to bounce back.	ಭಾರತದ ಆರ್ಥಿಕತೆಯ ಬಲವಾದ ಹೀರಿಕೊಳ್ಳುವ ಸಾಮರ್ಥ್ಯವೇ ಅದರ ಮೂಲಭೂತ ಶಕ್ತಿ ಮತ್ತು ಮತ್ತೆ ಪುಟಿದೇಳುವ ಸಾಮರ್ಥ್ಯವನ್ನು ತೋರಿಸುತ್ತದೆ ಎಂದು ಅವರು ಹೇಳಿದರು.
Prime Minister said that the sectors like Tourism, Urban Development, Infrastructure and Agri based Industry have a great potential to taking forward the economy and for employment generation.	ಪ್ರವಾಸೋದ್ಯಮ, ನಗರಾಭಿವೃದ್ಧಿ, ಮೂಲಸೌಕರ್ಯ ಮತ್ತು ಕೃಷಿ ಆಧಾರಿತ ಕೈಗಾರಿಕೆಗಳಂತಹ ಕ್ಷೇತ್ರಗಳು ಆರ್ಥಿಕತೆಯ ಬೆಳವಣಿಗೆಗೆ ಮತ್ತು ಉದ್ಯೋಗ ಸೃಷ್ಟಿಗೆ ಹೆಚ್ಚಿನ ಸಾಮರ್ಥ್ಯವನ್ನು ಹೊಂದಿವೆ ಎಂದು ಪ್ರಧಾನಿ ಹೇಳಿದರು.
Prime Minister said that this would also foster a positive mood and can do spirit in the society.	ಇದು ಸಕಾರಾತ್ಮಕ ಮನಸ್ಥಿತಿಯನ್ನು ಬೆಳೆಸುತ್ತದೆ ಮತ್ತು ಸಮಾಜದಲ್ಲಿ ಸಾಧಿಸಬಹುದು ಎಂಬ ಮನೋಭಾವವನ್ನು ಬೆಳೆಸುತ್ತದೆ ಎಂದು ಪ್ರಧಾನಿ ಹೇಳಿದರು.
Stating that India is land with unlimited possibilities he requested all stakeholders to do their bit to bridge the gap between reality and perception	ಭಾರತವು ಅಪರಿಮಿತ ಸಾಧ್ಯತೆಗಳನ್ನು ಹೊಂದಿರುವ ನೆಲ ಎಂದ ಅವರು, ವಾಸ್ತವ ಮತ್ತು ಗ್ರಹಿಕೆಗಳ ನಡುವಿನ ಅಂತರವನ್ನು ತೊಡೆದು ಹಾಕಲು ಎಲ್ಲಾ ಪಾಲುದಾರರು ತಮ್ಮ ಕೈಲಾದಷ್ಟು ಕೊಡುಗೆ ನೀಡಬೇಕು ಎಂದು ವಿನಂತಿಸಿಕೊಂಡರು.
Economists like Shri Shankar Acharya, Shri R Nagaraj, Msrzana Afridi, Venture Capitalist Shri Pradip Shah, Industrialists Shri Apparao Mallavarapu, Shri Deep Kalra, Shri Patanjali Govind Keswani, Shri Deepak Seth, Shri Srikumar Misra, Subject Experts Shri Ashish Dhawan and Shri Shiv Sarin were among the 38 delegates who participated in the discussions.	ಅರ್ಥಶಾಸ್ತ್ರಜ್ಞರಾದ ಶ್ರೀ ಶಂಕರ್ ಆಚಾರ್ಯ, ಶ್ರೀ ಆರ್ ನಾಗರಾಜ್, ಶ್ರೀಮತಿ ಫರ್ಜಾನಾ ಅಫ್ರಿದಿ, ವೆಂಚರ್ ಕ್ಯಾಪಿಟಲಿಸ್ಟ್ ಶ್ರೀ ಪ್ರದೀಪ್ ಷಾ, ಕೈಗಾರಿಕೋದ್ಯಮಿಗಳಾದ ಶ್ರೀ ಅಪ್ಪರಾವ್ ಮಲ್ಲವರಪು, ಶ್ರೀ ದೀಪ್ ಕಲ್ರಾ, ಶ್ರೀ ಪತಂಜಲಿ ಗೋವಿಂದ್ ಕೇಸ್ವಾನಿ, ಶ್ರೀ ದೀಪಕ್ ಸೇಠ್, ಶ್ರೀ ಶ್ರೀಕುಮಾರ್ ಮಿಶ್ರಾ, ವಿಷಯ ತಜ್ಞರಾದ ಶ್ರೀ ಆಶಿಶ್ ಧವನ್ ಮತ್ತು ಶ್ರೀ ಶಿವ್ ಸರೀನ್ ಚರ್ಚೆಯಲ್ಲಿ ಭಾಗವಹಿಸಿದ 38 ಪ್ರತಿನಿಧಿಗಳಲ್ಲಿದ್ದರು.
Minister for Home Affairs Shri Amit Shah, Union Minister for Road Transport & Highways and MSME Shri Nitin Gadkari, Minister for Railways and Commerce Shri Piyush Goyal and Minister for Agriculture & Farmers Welfare and Rural Development, Panchayati Raj Shri Narendra Tomar, Secretaries from various Ministries, Vice Chairman of NITI Aayog Shri Rajiv Kumar and CEO of NITI Aayog Shri Amitabh Kant attended the meeting.	ಗೃಹ ಸಚಿವ ಶ್ರೀ ಅಮಿತ್ ಶಾ, ಕೇಂದ್ರ ರಸ್ತೆ ಸಾರಿಗೆ ಮತ್ತು ಹೆದ್ದಾರಿ ಹಾಗೂ ಎಂಎಸ್ಎಂಇ ಸಚಿವ ಶ್ರೀ ನಿತಿನ್ ಗಡ್ಕರಿ, ರೈಲ್ವೆ ಮತ್ತು ವಾಣಿಜ್ಯ ಸಚಿವ ಶ್ರೀ ಪಿಯೂಷ್ ಗೋಯಲ್ ಮತ್ತು ಕೃಷಿ ಮತ್ತು ರೈತ ಕಲ್ಯಾಣ ಮತ್ತು ಗ್ರಾಮೀಣಾಭಿವೃದ್ಧಿ, ಪಂಚಾಯತಿ ರಾಜ್ ಸಚಿವ ಶ್ರೀ ನರೇಂದ್ರ ತೋಮರ್, ವಿವಿಧ ಸಚಿವಾಲಯಗಳ ಕಾರ್ಯದರ್ಶಿಗಳು, ನೀತಿ ಆಯೋಗದ ಉಪಾಧ್ಯಕ್ಷ ಶ್ರೀ ರಾಜೀವ್ ಕುಮಾರ್ ಮತ್ತು ನೀತಿ ಆಯೋಗದ ಕಾರ್ಯನಿರ್ವಹಣಾಧಿಕಾರಿ ಶ್ರೀ ಅಮಿತಾಭ್ ಕಾಂತ್ ಸಭೆಯಲ್ಲಿ ಭಾಗವಹಿಸಿದ್ದರು.
Prime Minister to proceed on a two day official visit to Kolkata on 11th and 12th January 2020	ಜನವರಿ 11 ಮತ್ತು 12, 2020 ರಂದು ಕೋಲ್ಕತ್ತಾಗೆ ಪ್ರಧಾನ ಮಂತ್ರಿ ಎರಡು ದಿನಗಳ ಅಧಿಕೃತ ಭೇಟಿ
Prime Minister Shri Narendra Modi is proceeding on a two day official visit to Kolkata on the 11thand 12thJanuary 2020	ಪ್ರಧಾನ ಮಂತ್ರಿ ಶ್ರೀ ನರೇಂದ್ರ ಮೋದಿ ಅವರು ಜನವರಿ 11 ಮತ್ತು 12, 2020ರ ಎರಡು ದಿನಗಳ ಅಧಿಕೃತ ಭೇಟಿಗಾಗಿ ಕೋಲ್ಕತ್ತಾಗೆ ತೆರಳುತ್ತಿದ್ದಾರೆ.
Dedication of Heritage Buildings to the Nation	ದೇಶಕ್ಕೆ ಪಾರಂಪರಿಕ ಕಟ್ಟಡಗಳ ಸಮರ್ಪಣೆ
On the 11thof January, the Prime Minister shall dedicate to the Nation Four Refurbished Heritage Buildings in Kolkata to the Nation.	ಜನವರಿ 11ರಂದು ಪ್ರಧಾನಮಂತ್ರಿಯವರು ಕೋಲ್ಕತ್ತಾದಲ್ಲಿ ನಾಲ್ಕು ಪುನರ್ ನವೀಕರಣಗೊಂಡ 4 ಪಾರಂಪರಿಕ ಕಟ್ಟಡಗಳ ರಾಷ್ಟ್ರಕ್ಕೆ ಸಮರ್ಪಣೆ,.
These are Old Currency Building, the Belvedere House, the Metcalfe House and the Victoria Memorial Hall	ಇವು ಓಲ್ಡ್ ಕರೆನ್ಸಿ ಕಟ್ಟಡ, ಬೆಲ್ವೆಡೆರೆ ಹೌಸ್, ಮೆಟ್ಕಾಲ್ಫ್ ಹೌಸ್ ಮತ್ತು ವಿಕ್ಟೋರಿಯಾ ಮೆಮೋರಿಯಲ್ ಹಾಲ್ ಗಳಾಗಿವೆ.
The Union Ministry of Culture has renovated these 4 iconic galleries and refurbished them with new exhibitions while curating the old galleries.	ಕೇಂದ್ರ ಸಂಸ್ಕೃತಿ ಸಚಿವಾಲಯವು ಈ ನಾಲ್ಕು ಪಾರಂಪರಿಕ ಗ್ಯಾಲರಿಗಳ ಕಟ್ಟಡಗಳನ್ನು ನವೀಕರಿಸಿದ್ದು, ಅವುಗಳಲ್ಲಿ ಹಳೆಯ ಪ್ರದರ್ಶನ ಶಾಲೆಯ ವಸ್ತುಗಳನ್ನು ಒಪ್ಪ ಓವರಣವಾಗಿ ಜೋಡಿಸಿ, ಹೊಸ ವಸ್ತು ಪ್ರದರ್ಶನದಂತೆ ನವೀಕರಿಸಿದ್ದಾರೆ.
Ministry of Culture under the direction of the Prime Minister Shri Narendra Modi is developing cultural spaces around iconic buildings in various metro cities in the country	ಸಂಸ್ಕೃತಿ ಸಚಿವಾಲಯವು ಪ್ರಧಾನಮಂತ್ರಿ ಶ್ರೀ ನರೇಂದ್ರ ಮೋದಿ ಅವರ ನಿರ್ದೇಶನದ ಅಡಿಯಲ್ಲಿ, ದೇಶದ ವಿವಿಧ ಬೃಹನ್ ನಗರಗಳಲ್ಲಿನ ವಿವಿಧ ಅಪ್ರತಿಮ ಕಟ್ಟಡಗಳ ಸುತ್ತ ಸಾಂಸ್ಕೃತಿಕ ಪ್ರದೇಶಗಳನ್ನು ಅಭಿವೃದ್ಧಿಪಡಿಸುತ್ತಿದೆ.
To begin with the cities of Kolkata, Delhi, Mumbai, Ahmedabad and Varanasi are being taken up under this project.	ಕೋಲ್ಕತ್ತಾ, ದೆಹಲಿ, ಮುಂಬೈ, ಅಹಮದಾಬಾದ್ ಮತ್ತು ವಾರಾಣಸಿಯಲ್ಲಿ ಈ ಯೋಜನೆಯನ್ನು ಆರಂಭಿಕವಾಗಿ ಕೈಗೆತ್ತಿಕೊಳ್ಳಲಾಗಿದೆ.
Sesquicentenary Celebrations of the Kolkata Port Trust (KoPT)	ಕೋಲ್ಕತ್ತಾ ಬಂದರು ಟ್ರಸ್ಟ್ (ಕೆಿ ಿ) 150ನೇ ವಾರ್ಷಿಕೋತ್ಸವ
Shri Narendra Modi shall be handing over a Cheque of Rs 501 Crore towards final instalment to meet the deficit of pension fund of retired and existing employees of the Kolkata Port Trust.	ಶ್ರೀ ನರೇಂದ್ರ ಮೋದಿ ಅವರು ಕೋಲ್ಕತ್ತಾ ಬಂದರು ಟ್ರಸ್ಟ್ ನಿವೃತ್ತ ಮತ್ತು ಹಾಲಿ ಉದ್ಯೋಗಿಗಳ ಪಿಂಚಣಿಯ ಸೇವಾ ಯೋಜನೆ ಸರಿದೂಗಿಸಲು ಅಂತಿಮ ಕಂತಿನ 501 ಕೋಟಿ ರೂಪಾಯಿಗಳ ಚೆಕ್ ಅನ್ನು ಹಸ್ತಾಂತರಿಸಲಿದ್ದಾರೆ.
In a memorable event, the Prime Minister shall also be felicitating two oldest pensioners of the Kolkata Port Trust Shri Nagina Bhagat and Shri Naresh Chandra Chakraborty (105 and 100 years respectively).	ಸ್ಮರಣಾರ್ಹವಾದ ಕಾರ್ಯಕ್ರಮದಲ್ಲಿ ಪ್ರಧಾನಮಂತ್ರಿಯವರು ಕೋಲ್ಕತ್ತಾ ಬಂದರು ಟ್ರಸ್ಟ್ ಇಬ್ಬರು ಹಿರಿಯ ಪಿಂಚಣಿದಾರರಾದ (ಅನುಕ್ರಮವಾಗಿ 105 ಮತ್ತು 100 ವರ್ಷದ) ಶಅರೀ ನಗೀನಾ ಭಗತ್ ಮತ್ತು ಶ್ರೀ ನರೇಶ್ ಚಂದ್ರ ಚಕ್ರಬೋರ್ತಿ ಅವರನ್ನು ಸನ್ಮಾನಿಸಲಿದ್ದಾರೆ.
The Prime Minister shall also launch the Port Anthem during the event.	ಈ ಸಮಾರಂಭದ ವೇಳೆ ಪ್ರಧಾನಮಂತ್ರಿಯವರು ಬಂದರಿನ ಗೀತೆಗೆ ಚಾಲನೆ ನೀಡಲಿದ್ದಾರೆ.
Shri Modi shall also unveil a plaque of 150 years of commemorative installation at the site of original Port Jetties.	ಶ್ರೀ ಮೋದಿ ಅವರು ಮೂಲ ಬಂದರು ಜಟ್ಟಿಗಳ ತಾಣದಲ್ಲಿ 150ನೇ ವರ್ಷದ ಸ್ಮಾರಕದ ಅಂಗವಾಗಿ ಫಲಕ ಅನಾವರಣ ಮಾಡಲಿದ್ದಾರೆ.
The Prime Minister shall also inaugurate the upgraded Ship Repair Faciility of Cochin Kolkata Ship Repair Unit at Netaji Subhas Dry Dock.	ಪ್ರಧಾನಮಂತ್ರಿಯವರು ಕೋಚಿನ್ ಕೋಲ್ಕತ್ತಾ ಹಡಗು ರಿಪೇರಿ ಘಟಕದ ಮೇಲ್ದರ್ಜೆಗೇರಿಸಲಾದ ಹಡಗು ದುರಸ್ತಿ ವ್ಯವಸ್ಥೆಯನ್ನು ನೇತಾಜಿ ಸುಭಾಷ್ ಡ್ರೈ ಡಾಕ್ ನಲ್ಲಿ ಉದ್ಘಾಟಿಸಲಿದ್ದಾರೆ
Shri Narendra Modi shall inaugurate the Full Rake Handling Facility while dedicating the upgraded Railway Infrastructure of Kolkata Dock System of KoPT for smooth cargo movement and improving turnaround time.	ಶ್ರೀ ನರೇಂದ್ರ ಮೋದಿ ಅವರು ಪೂರ್ಣ ರೇಕ್ ಹ್ಯಾಂಡ್ಲಿಂಗ್ ಸೌಲಭ್ಯವನ್ನು ಉದ್ಘಾಟಿಸಲಿದ್ದಾರೆ ಮತ್ತು ಸುಗಮ ಸರಕು ಸಾಗಣೆಗಾಗಿ ಮತ್ತು ನಿಗದಿತ ಸಮಯದಲ್ಲಿನ ಕಾರ್ಯಪಾಲನೆಗಾಗಿ ಕೋಲ್ಕತ್ತಾ ಬಂದರು ಟ್ರಸ್ಟ್ ಕೋಲ್ಕತಾ ಡಾಕ್ ವ್ಯವಸ್ಥೆಯ ನವೀಕೃತ ರೈಲ್ವೆ ಮೂಲಸೌಕರ್ಯವನ್ನು ಸಮರ್ಪಿಸಲಿದ್ದಾರೆ.
Prime Minister inaugurated Kaushal Vikas Kendra and Pritilata Chhatra Avas for 200 Tribal girl students of Sunderbans.	ಪ್ರಧಾನಮಂತ್ರಿಯವರು ಕೌಶಲ ವಿಕಾಸ ಕೇಂದ್ರ ಮತ್ತು ಸುಂದರ ಬನದ 200 ಬುಡಕಟ್ಟು ಶಾಲಾ ಬಾಲಕಿಯರಿಗಾಗಿ ಪ್ರೀತಿಲತಾ ಛತ್ರಿ ವಸತಿ ಗೃಹವನ್ನು ಉದ್ಘಾಟಿಸಲಿದ್ದಾರೆ.
Telephone Conversation between Prime Ministerand Emmanuel Macron, President of the French Republic	ಪ್ರಧಾನಮಂತ್ರಿ ಮತ್ತು ಫ್ರೆಂಚ್ ಗಣರಾಜ್ಯದ ಅಧ್ಯಕ್ಷ ಇಮ್ಯಾನುಯಲ್ ಮಾಕ್ರಾನ್ ನಡುವೆ ದೂರವಾಣಿ ಸಮಾಲೋಚನೆ
On the occasion of the New Year, Prime Minister Shri Narendra Modi had a telephoneconversation today with Emmanuel Macron, President of the French Republic.	ಹೊಸ ವರ್ಷಾಚರಣೆ ವೇಳೆ ಪ್ರಧಾನಮಂತ್ರಿ ಶ್ರೀ ನರೇಂದ್ರ ಮೋದಿ ಅವರು, ಫ್ರೆಂಚ್ ಗಣರಾಜ್ಯದ ಅಧ್ಯಕ್ಷ ಇಮ್ಯಾನುಯಲ್ ಮಾಕ್ರಾನ್ ಜೊತೆ ದೂರವಾಣಿ ಮೂಲಕ ಸಮಾಲೋಚನೆ ನಡೆಸಿದರು.
The Prime Minister conveyed to President Macron his New Year greetings and good wishes on behalf of the people of India and on his own behalf.	ಪ್ರಧಾನಿ ಅವರು, ಅಧ್ಯಕ್ಷ ಮಾಕ್ರಾನ್ ಅವರಿಗೆ ಭಾರತದ ಪರವಾಗಿ ಹಾಗೂ ವೈಯಕ್ತಿಕವಾಗಿ ಹೊಸ ವರ್ಷದ ಶುಭಾಶಯಗಳನ್ನು ಕೋರಿದರು.
The Prime Minister recalled his earlier meetings with President Macron, including at Biarritz and Chantilly	ಪ್ರಧಾನಮಂತ್ರಿ ಅವರು, ಅಧ್ಯಕ್ಷ ಮಾಕ್ರಾನ್ ಜೊತೆಗಿನ ಬೈರ್ರಿಟ್ಜ್ ಮತ್ತು ಚಾಂಟಿಲ್ಲಿ ಸೇರಿದಂತೆ ಹಿಂದಿನ ಸಭೆಗಳನ್ನು ನೆನಪು ಮಾಡಿಕೊಂಡರು.
He reiterated his commitment to further strengthening the Strategic Partnership between India and France	ಭಾರತ ಮತ್ತು ಫ್ರಾನ್ಸ್ ನಡುವಿನ ಕಾರ್ಯತಂತ್ರ ಪಾಲುದಾರಿಕೆ ಮತ್ತಷ್ಟು ಬಲವರ್ಧನೆಗೆ ಅವರು ತಮ್ಮ ಬದ್ಧತೆಯನ್ನು ಪುನರುಚ್ಚರಿಸಿದರು.
He expressed his satisfaction at the steady progress in the multi-faceted relationship between the two countries.	ಎರಡೂ ದೇಶಗಳ ನಡುವೆ ಬಹು ಆಯಾಮದ ಸಂಬಂಧಗಳ ಸ್ಥಿರ ಪ್ರಗತಿಯ ಬಗ್ಗೆ ಅವರು ತೃಪ್ತಿ ವ್ಯಕ್ತಪಡಿಸಿದರು.
The two leaders exchanged views on a range of issues of mutual interest in bilateral relations as well as regional and global situations.	ಉಭಯ ನಾಯಕರು ಪರಸ್ಪರ ಹಿತಾಸಕ್ತಿಯ ದ್ವಿಪಕ್ಷೀಯ ಸಂಬಂಧಗಳು ಮಾತ್ರವಲ್ಲದೆ, ಪ್ರಾದೇಶಿಕ ಮತ್ತು ಜಾಗತಿಕ ಸ್ಥಿತಿಗತಿಗಳ ಕುರಿತ ವಿಷಯಗಳ ಬಗ್ಗೆ ಅಭಿಪ್ರಾಯ ವಿನಿಮಯ ಮಾಡಿಕೊಂಡರು.
They agreed on keeping in touch and further enhancing all-round strategic cooperation between the two countries, including in the areas of defence, civil nuclear energy and maritime security.	ಉಭಯ ನಾಯಕರು ನಿರಂತರ ಸಂಪರ್ಕದಲ್ಲಿರುವ ಒಪ್ಪಿದರು ಮತ್ತು ರಕ್ಷಣೆ, ನಾಗರಿಕ ಅಣು ಇಂಧನ, ಸಾಗರ ಭದ್ರತೆ ಸೇರಿದಂತೆ ಎರಡೂ ದೇಶಗಳ ನಡುವೆ ಸಮಗ್ರ ಕಾರ್ಯತಂತ್ರ ಪಾಲುದಾರಿಕೆಯನ್ನು ಮತ್ತಷ್ಟು ವೃದ್ಧಿಸಲು ಸಮ್ಮತಿಸಿದರು.
PM Modi attends 150th anniversary celebration of Kolkata Port Trust in Kolkatalaunches Interactive Light & Sound Show of Rabindra Setu	ಕೋಲ್ಕತ್ತಾದಲ್ಲಿ ಪ್ರಧಾನಮಂತ್ರಿ ಮೋದಿಯವರು ಕೋಲ್ಕತ್ತಾ ಬಂದರು ಟ್ರಸ್ಟ್ ನ 150ನೇ ವಾರ್ಷಿಕೋತ್ಸವದಲ್ಲಿ ಭಾಗವಹಿಸಿದ್ದರು ಬೀಂದ್ರ ಸೇತುವೆಯ ಸಂವಾದನಾತ್ಮಕ ಧ್ವನಿ ಮತ್ತು ಬೆಳಕಿನ ಪ್ರದರ್ಶನಕ್ಕೆ ಚಾಲನೆ ನೀಡಿದರು
Prime Minister Shri Narendra Modi attended the 150th anniversary celebration of Kolkata Port Trust in Kolkata today	ಕೋಲ್ಕತ್ತಾದಲ್ಲಿಂದು ಪ್ರಧಾನಮಂತ್ರಿ ಶ್ರೀ ನರೇಂದ್ರ ಮೋದಿ ಅವರು ಕೋಲ್ಕತ್ತಾ ಬಂದರು ಟ್ರಸ್ಟ್ ನ 150ನೇ ವಾರ್ಷಿಕೋತ್ಸವ ಸಮಾರಂಭದಲ್ಲಿ ಪಾಲ್ಗೊಂಡಿದ್ದರು.
On the occasion, He launched the Interactive Light & Sound Show of Rabindra Setu (Howrah Bridge) in Kolkata	ಈ ಸಂದರ್ಭದಲ್ಲಿ ಅವರು ಕೋಲ್ಕತ್ತಾದ ರಬೀಂದ್ರ ಸೇತುವೆ (ಹೌರಾ ಸೇತುವೆ)ಯ ಸಂವಾದನಾತ್ಮಕ ಧ್ವನಿ ಮತ್ತು ಬೆಳಕಿನ ಪ್ರದರ್ಶನಕ್ಕೆ ಚಾಲನೆ ನೀಡಿದರು.
Governor of West Bengal Shri Jagdeep Dhankhar, Chief Minister Msmata Banerjee and other dignitaries were present on the occasion.	ಪಶ್ಚಿಮ ಬಂಗಾಳದ ರಾಜ್ಯಪಾಲ ಶ್ರೀ ಜಗದೀಪ್ ಧನಕರ್, ಮುಖ್ಯಮಂತ್ರಿ ಕುಮಾರಿ ಮಮತಾ ಬ್ಯಾನರ್ಜಿ ಮತ್ತು ಇತರ ಗಣ್ಯರು ಸಮಾರಂಭದಲ್ಲಿ ಭಾಗಿಯಾಗಿದ್ದರು.
The new decorative lighting of the Rabindra Setu has 650 power-efficient LED and spotlight fittings for a programmable multi-colour lighting including a show that will sync with music	ರಬೀಂದ್ರ ಸೇತುವೆಯ ನೂತನ ದೀಪಾಲಂಕಾರವು ಸಂಗೀತದೊಂದಿಗೆ ಮೇಳೈಸುವ ಪ್ರದರ್ಶನವನ್ನು ಒಳಗೊಂಡಂತೆ ಕಾರ್ಯಕ್ರಮರೂಪಿತ ಬಹು-ವರ್ಣದ ಬೆಳಕಿಗಾಗಿ 650 ವಿದ್ಯುತ್ ಕ್ಷಮತೆಯ ಎಲ್ಿ ತ್ತು ಪ್ರಕಾಶಮಾನ ವಿದ್ಯುತ್ ದೀಪಗಳಿಂದ ಕೂಡಿದೆ.
The new interactive show is expected to help attract tourists and locals.	ಹೊಸ ಸಂವಾದನಾತ್ಮಕ ಪ್ರದರ್ಶನವು ಸ್ಥಳೀಯರು, ಪ್ರವಾಸಿಗರನ್ನು ಸೆಳೆಯಲು ನೆರವಾಗಲಿದೆ.
It consumed 26,500 tonnes of steel, out of which 23,000 tonnes of high-tensile alloy steel.	ಇದರ ನಿರ್ಮಾಣಕ್ಕೆ 26,500 ಟನ್ ಉಕ್ಕು ಬಳಸಲಾಗಿದೆ, ಈ ಪೈಕಿ 23ಸಾವಿರ ಟನ್ ಹೈ ಟೆನ್ಸಿಲ್ ಮಿಶ್ರ ಸ್ಟೀಲ್ ಬಳಕೆಯಾಗಿದೆ.
Prime Minister Dedicates Four Refurbished Heritage Buildings in Kolkata to the Nation	ಕೋಲ್ಕತ್ತಾದಲ್ಲಿ ನಾಲ್ಕು ನವೀಕೃತ ಪಾರಂಪರಿಕ ಕಟ್ಟಡಗಳನ್ನು ದೇಶಕ್ಕೆ ಸಮರ್ಪಿಸಿದ ಪ್ರಧಾನಮಂತ್ರಿ
The Prime Minister Shri Narendra Modi dedicated to the nation Four Refurbished Heritage Buildings in Kolkata today	ಪ್ರಧಾನಮಂತ್ರಿ ಶ್ರೀ ನರೇಂದ್ರ ಮೋದಿ ಅವರು ಕೋಲ್ಕತ್ತಾದಲ್ಲಿಂದು ನಾಲ್ಕು ನವೀಕೃತ ಪಾರಂಪರಿಕ ಕಟ್ಟಡಗಳನ್ನು ದೇಶಕ್ಕೆ ಸಮರ್ಪಿಸಿದರು.
These are Old Currency Building, the Belvedere House, the Metcalfe House and the Victoria Memorial Hall	ಇವು ಓಲ್ಡ್ ಕರೆನ್ಸಿ ಬಿಲ್ಡಿಂಗ್, ಬೆಲ್ವೆಡೆರೆ ಹೌಸ್, ಮೆಟ್‌ಕಾಲ್ಫ್ ಹೌಸ್ ಮತ್ತು ವಿಕ್ಟೋರಿಯಾ ಮೆಮೋರಿಯಲ್ ಹಾಲ್ ಗಳಾಗಿವೆ.
Speaking on the occasion, Prime Minister termed it as a special day, as it begins anationwide campaign to preserve Indias art, culture and heritage,and to Reinvent, Rebrand, Renovate and Rehouse them.	ಈ ಸಂದರ್ಭದಲ್ಲಿ ಮಾತನಾಡಿದ ಪ್ರಧಾನಮಂತ್ರಿಯವರು, ಭಾರತದ ಕಲೆ, ಸಂಸ್ಕೃತಿ ಮತ್ತು ಪರಂಪರೆಯನ್ನು ಸಂರಕ್ಷಿಸಲು ಮತ್ತು ಅವುಗಳನ್ನು ಮರುಶೋಧಿಸಲು, ರಿಬ್ರಾಂಡ್ ಮಾಡಲು, ನವೀಕರಿಸಲು ಮತ್ತು ಪುನರ್ ಸ್ಥಾಪಿಸಲು ದೇಶವ್ಯಾಪಿ ನಡೆಯುತ್ತಿರುವ ಆಂದೋಲನದಕ್ಕೆ ನಾಂದಿಯಾಗಿದ್ದು, ಇದೊಂದು ವಿಶೇಷ ದಿನ ಎಂದು ಬಣ್ಣಿಸಿದರು.
Centre of Heritage Tourism for theWorld:	ವಿಶ್ವದ ಪಾರಂಪರಿಕ ಪ್ರವಾಸೋದ್ಯಮ ಕೇಂದ್ರ:
This is being started from the Indian Museum in Kolkata, which is one of the oldest museums in the world, he added.	ವಿಶ್ವದ ಅತ್ಯಂತ ಹಳೆಯ ವಸ್ತುಸಂಗ್ರಹಾಲಯಗಳಲ್ಲಿ ಒಂದಾದ ಕೋಲ್ಕತ್ತಾದ ಭಾರತೀಯ ವಸ್ತುಸಂಗ್ರಹಾಲಯದಿಂದ ಇದನ್ನು ಪ್ರಾರಂಭಿಸಲಾಗುತ್ತಿದೆ ಎಂದೂ ಅವರು ತಿಳಿಸಿದರು.
Shri Modi said that inorder to generate resources, take care of the management of these iconic cultural heritage centres, the union government is considering to launchIndian Institute of Heritage Conservationwhich would be given the status of a deemed university.	ಸಂಪನ್ಮೂಲ ಸೃಷ್ಟಿಸುವ ಸಲುವಾಗಿ, ಈ ಮಹತ್ವದ ಸಂಕೇತದ ಸಾಂಸ್ಕೃತಿಕ ಪಾರಂಪರಿಕ ಕೇಂದ್ರಗಳ ನಿರ್ವಹಣೆಗಾಗಿ, ಕೇಂದ್ರ ಸರ್ಕಾರ ಭಾರತೀಯ ಪರಂಪರೆಯ ಸಂರಕ್ಷಣಾ ಸಂಸ್ಥೆಯನ್ನು ಆರಂಭಿಸಲು ಚಿಂತಿಸುತ್ತಿದೆ, ಇದಕ್ಕೆ ಸ್ವಾಯತ್ತ ವಿಶ್ವವಿದ್ಯಾಲಯದ ಸ್ಥಾನ ನೀಡಲಾಗುವುದು ಎಂದು ಶ್ರೀ ಮೋದಿ ಹೇಳಿದರು.
Prime Minister said the renovation work of four Iconic Galleries of Kolkata- Old Currency Building, Belvedere House, Victoria Memorial and Metcalfe House has been completed	ಕೋಲ್ಕತ್ತಾದ ನಾಲ್ಕು ಐಕಾನಿಕ್ ವಸ್ತುಸಂಗ್ರಹಾಲಯಗಳಾದ ಓಲ್ಡ್ ಕರೆನ್ಸಿ ಬಿಲ್ಡಿಂಗ್, ಬೆಲ್ವೆಡೆರೆ ಹೌಸ್, ಮೆಟ್‌ಕಾಲ್ಫ್ ಹೌಸ್ ಮತ್ತು ವಿಕ್ಟೋರಿಯಾ ಮೆಮೋರಿಯಲ್ ಹಾಲ್ ಗಳ ನವೀಕರಣ ಕಾಮಗಾರಿ ಪೂರ್ಣಗೊಂಡಿದೆ ಎಂದು ಪ್ರಧಾನಮಂತ್ರಿ ತಿಳಿಸಿದರು.
He also said that Government is taking efforts towards developing Belvedere House into a Museum of the World.	ಸರ್ಕಾರವು ಬೆಲ್ವೆಡೆರೆ ಹೌಸ್ ಅನ್ನು ವಿಶ್ವದ ವಸ್ತುಸಂಗ್ರಹಾಲಯವಾಗಿ ಅಭಿವೃದ್ಧಿಪಡಿಸುವ ಪ್ರಯತ್ನ ಕೈಗೊಂಡಿದೆ ಎಂದು ಅವರು ತಿಳಿಸಿದರು.
Shri Modi said that Government of India is contemplating to set up a museum of Coinage & Commerceat the Indian Government Mint in Kolkata.	ಕೋಲ್ಕತ್ತಾದಲ್ಲಿರುವ ಭಾರತ ಸರ್ಕಾರದ ನಾಣ್ಯಾಗಾರದಲ್ಲಿನಾಣ್ಯ ಮತ್ತು ವಾಣಿಜ್ಯವಸ್ತುಸಂಗ್ರಹಾಲಯವನ್ನು ಸ್ಥಾಪಿಸಲು ಭಾರತ ಸರ್ಕಾರ ಚಿಂತನೆ ನಡೆಸುತ್ತಿದೆ ಎಂದು ಶ್ರೀ ಮೋದಿ ಹೇಳಿದರು.
He said keeping in mind the decades old sentiments of India towards Subhas Chandra Bose a museum had been set up at the Red Fort in Delhi and that an island in the archipelago of the Andaman & Nicobar had been named after him.	ಸುಭಾಷ್ ಚಂದ್ರ ಬೋಸ್ ಅವರ ಬಗ್ಗೆ ಭಾರತ ದಶಕಗಳಿಂದ ಹೊಂದಿರುವ ಭಾವನೆಗಳನ್ನು ಗಮನದಲ್ಲಿಟ್ಟುಕೊಂಡು, ದೆಹಲಿಯ ಕೆಂಪು ಕೋಟೆಯಲ್ಲಿ ಒಂದು ವಸ್ತುಸಂಗ್ರಹಾಲಯ ಸ್ಥಾಪಿಸಲಾಗಿದೆ ಮತ್ತು ಅಂಡಮಾನ್ ಮತ್ತು ನಿಕೋಬಾರ್ ದ್ವೀಪ ಸಮೂಹದಲ್ಲಿರುವ ದ್ವೀಪವೊಂದಕ್ಕೆ ಅವರ ಹೆಸರಿಡಲಾಗಿದೆ ಎಂದು ಅವರು ಹೇಳಿದರು.
Tributes to Iconic Leaders of Bengal	ಬಂಗಾಲದ ಮೇರು ನಾಯಕರಿಗೆ ಶ್ರದ್ಧಾಂಜಲಿ
Prime Minister said in the new era, the iconic leaders and sons of soil of West Bengal who dedicated their lives for the freedom of the country should be paid proper tributes.	ನವ ಯುಗದಲ್ಲಿ, ದೇಶದ ಸ್ವಾತಂತ್ರ್ಯಕ್ಕಾಗಿ ತಮ್ಮ ಜೀವನವನ್ನು ಮುಡಿಪಾಗಿಟ್ಟ ಪಶ್ಚಿಮ ಬಂಗಾಳದ ಮೇರು ನಾಯಕರು ಮತ್ತು ಪುತ್ರರಿಗೆ ಸರಿಯಾದ ಗೌರವ ಸಲ್ಲಿಸಬೇಕು ಎಂದು ಪ್ರಧಾನಿ ಹೇಳಿದರು.
Now we are celebrating the 200th Birth Anniversary of Shri Ishwar Chandra Vidyasagar	ನಾವು ಈಗ ಶ್ರೀ ಈಶ್ವರ ಚಂದ್ರ ವಿದ್ಯಾಸಾಗರ್ ಅವರ 200ನೇ ಜಯಂತಿ ಆಚರಿಸುತ್ತಿದ್ದೇವೆ.
Similarly the year 2022 when India celebrates its 75th Independence, is also the 250th birth anniversary of renowned social reformer and educationist Shri Raja Ram Mohan Rai	ಅದೇ ರೀತಿ 2022ರಲ್ಲಿ ಭಾರತ 75ನೇ ಸ್ವಾತಂತ್ರ್ಯೋತ್ಸವ ಆಚರಿಸುವಾಗ ಹೆಸರಾಂತ ಸಮಾಜ ಸುಧಾರಕ ಮತ್ತು ಶಿಕ್ಷಣತಜ್ಞ ಶ್ರೀ ರಾಜಾ ರಾಮ್ ಮೋಹನ ರಾಯ್ ಅವರ 250ನೇ ಜಯಂತಿಯನ್ನೂ ಆಚರಿಸುತ್ತೇವೆ.
In this spirit we should celebrate his 250th birth anniversary as a festival of grandeur.	ಈ ಸ್ಫೂರ್ತಿಯಲ್ಲಿ ನಾವು ಅವರ 250ನೇ ಜಯಂತಿಯನ್ನು ಹಿರಿಮೆಯ ಹಬ್ಬವಾಗಿ ಆಚರಿಸಬೇಕು ಎಂದು ಹೇಳಿದರು.
Prime Minister said that preserving Indian Heritage, Indias Great Leaders, Indias History is one of the main aspect of Nation Building.	ಭಾರತೀಯ ಪರಂಪರೆ, ಭಾರತದ ಶ್ರೇಷ್ಠ ನಾಯಕರುಗಳು, ಭಾರತದ ಇತಿಹಾಸ ಸಂರಕ್ಷಣೆಯು ರಾಷ್ಟ್ರ ನಿರ್ಮಾಣದ ಪ್ರಮುಖ ಅಂಶಗಳಲ್ಲಿ ಒಂದಾಗಿದೆ ಎಂದು ಪ್ರಧಾನಮಂತ್ರಿ ಹೇಳಿದರು.
It is very sad that the History of India written during the British regime had left out many important aspects out of it	ಭಾರತದ ಇತಿಹಾಸವನ್ನು ಬ್ರಿಟಿಷರ ಕಾಲದಲ್ಲಿ ಬರೆಯಲಾಗಿದ್ದು, ಹಲವು ಮಹತ್ವದ ಅಂಶಗಳು ಇದರಿಂದ ಬಿಟ್ಟು ಹೋಗಿದೆ ಎಂಬುದು ಅತ್ಯಂತ ದುಃಖದ ಸಂಗತಿ.
I would like to quote what Gurudev Rabindranath Tagore wrote in 1903,Indias history is not what we study and memorize for our exams	ನಾನು ಗುರುದೇವ ರಬೀಂದ್ರ ನಾಥ ಠಾಗೋರ್ ಅವರು 1903ರಲ್ಲಿ ಬರೆದಿದ್ದನ್ನು ಉಲ್ಲೇಖಿಸಲು ಇಚ್ಛಿಸುತ್ತೇನೆ.
It only talks about how people from outside have tried to conquer us, how children tried to kill their fathers and how brothers fought among themselves for the throne	ಹೊರಗಿನಿಂದ ಬಂದ ಜನರು ನಮ್ಮನ್ನು ಹೇಗೆ ಗೆಲ್ಲಲು ಪ್ರಯತ್ನಿಸಿದರು, ಮಕ್ಕಳು ತಮ್ಮ ತಂದೆಯನ್ನು ಹೇಗೆ ಕೊಲ್ಲಲು ಪ್ರಯತ್ನಿಸಿದರು ಮತ್ತು ಸಹೋದರರು ಸಿಂಹಾಸನಕ್ಕಾಗಿ ತಮ್ಮ ನಡುವೆ ಹೇಗೆ ಕಚ್ಚಾಡಿದರು ಎಂಬುದರ ಬಗ್ಗೆ ಮಾತ್ರವೇ ಇದು ಹೇಳುತ್ತದೆ.
It does not give them any importance .	ಅದು ಅವರಿಗೆ ಯಾವುದೇ ಪ್ರಾಮುಖ್ಯತೆಯನ್ನು ನೀಡುವುದಿಲ್ಲ.
Gurudev also said,Whatever may be the strength of the storm, more important is how the people who faced it dealt with it.	ಗುರುದೇವ್ ಇನ್ನೂ ಒಂದು ಹೇಳುತ್ತಾರೆಚಂಡಮಾರುತದ ಶಕ್ತಿ ಏನೇ ಇರಲಿ, ಅದನ್ನು ಎದುರಿಸಿದ ಜನರು ಅದನ್ನು ಹೇಗೆ ಎದುರಿಸಿದರು ಎಂಬುದು ಹೆಚ್ಚು ಮುಖ್ಯವಾಗುತ್ತದೆ.
PM condoles demise of DrChidananda Murthy	ಡಾ ಂ ಿದಾನಂದ ಮೂರ್ತಿ ನಿಧನಕ್ಕೆ ಪ್ರಧಾನಮಂತ್ರಿ ಸಂತಾಪ
PM condoles demise of DrChidananda Murthy	ಎಂ ಿದಾನಂದ ಮೂರ್ತಿ ನಿಧನಕ್ಕೆ ಪ್ರಧಾನಮಂತ್ರಿ ಸಂತಾಪ
The Prime Minister Shri Narendra Modi has condoled the demise of DrChidananda Murthy	ಪ್ರಧಾನಮಂತ್ರಿ ಶ್ರೀ ನರೇಂದ್ರ ಮೋದಿ ಅವರು, ಡಾ.
PM condoles demise of DrChidananda Murthy	ಎಂ ಿದಾನಂದ ಮೂರ್ತಿ ಅವರ ನಿಧನಕ್ಕೆ ಸಂತಾಪ ಸೂಚಿಸಿದ್ದಾರೆ.
Condolences to his family and admirers	ಅವರ ಕುಟುಂಬ ಮತ್ತು ಅವರ ಅನುಯಾಯಿಗಳಿಗೆ ಸಂತಾಪಗಳು.
Om Shanti, the Prime Minister said.	ಓಂ ಶಾಂತಿ” ಎಂದು ಪ್ರಧಾನಮಂತ್ರಿ ಹೇಳಿದ್ದಾರೆ.
The Prime Minister, Shri Narendra Modi has condoled the loss of lives due to a road accident in Kannauj, Uttar Pradesh	ಪ್ರಧಾನಮಂತ್ರಿ ಶ್ರೀ ನರೇಂದ್ರ ಮೋದಿ ಅವರು, ಉತ್ತರ ಪ್ರದೇಶದ ಕನ್ನೂಜ್ ನಲ್ಲಿ ರಸ್ತೆ ಅಪಘಾತದಲ್ಲಿ ಮೃತಪಟ್ಟ ಕುಟುಂಬದವರಿಗೆ ಸಂತಾಪ ಸೂಚಿಸಿದ್ದಾರೆ.
PM condoles the passing away of His Majesty Sultan Qaboos bin Said al Said	ಗೌರವಾನ್ವಿತ ಸುಲ್ತಾನ್ ಖಾಬೂಸ್ ಬಿನ್ ಸೈಯದ್ ಅಲ್ ಸೈಯದ್ ನಿಧನಕ್ಕೆ ಪ್ರಧಾನಿ ಸಂತಾಪ
The Prime Minister Shri Narendra Modi has condoled the passing away of His Majesty Sultan Qaboos bin Said al Said	ಪ್ರಧಾನಮಂತ್ರಿ ಶ್ರೀ ನರೇಂದ್ರ ಮೋದಿ ಅವರು, ಗೌರವಾನ್ವಿತ ಸುಲ್ತಾನ್ ಖಾಬೂಸ್ ಬಿನ್ ಸೈಯದ್ ಅಲ್ ಸೈಯದ್ ನಿಧನಕ್ಕೆ ಸಂತಾಪ ಸೂಚಿಸಿದ್ದಾರೆ.
He was a beacon of peace for our region and the world.	ಅವರು ನಮ್ಮ ಪ್ರಾಂತ್ಯದಲ್ಲಿ ಮತ್ತು ಜಗತ್ತಿನಲ್ಲಿ ಶಾಂತಿಯ ಧ್ಯೋತಕವಾಗಿದ್ದರು”.
May his soul rest in peace, the Prime Minister said	ಅವರ ಆತ್ಮಕ್ಕೆ ಶಾಂತಿ ದೊರಕಲಿ” ಎಂದು ಪ್ರಧಾನಮಂತ್ರಿ ಹೇಳಿದರು.
Prime Minister congratulates HM Sayyid Haitham bin Tariq al Said, Sultan of Oman	ಒಮನ್ ನ ದೊರೆ ಗೌರವಾನ್ವಿತ ಸೈಯೀದ್ ಹೈಥಮ್ ಬಿನ್  ತಾರಿಖ್ ಅಲ್ ಸೈಯದ್ ರನ್ನುಅಭಿನಂದಿಸಿದ ಪ್ರಧಾನಮಂತ್ರಿ
Prime Minister Shri Narendra Modi has congratulated HM Sayyid Haitham bin Tariq al Said, on taking over as Sultan of Oman.	ಪ್ರಧಾನಮಂತ್ರಿ ಶ್ರೀ ನರೇಂದ್ರ ಮೋದಿ ಅವರು, ಒಮನ್ ನ ನೂತನ ದೊರೆಯಾಗಿ ಅಧಿಕಾರ ವಹಿಸಿಕೊಂಡ ಗೌರವಾನ್ವಿತ ಸೈಯೀದ್ ಹೈಥಮ್ ಬಿನ್ ತಾರಿಖ್ ಅಲ್ ಸೈಯದ್ ಅವರನ್ನು ಅಭಿನಂದಿಸಿದ್ದಾರೆ.
I heartily congratulate HM Sayyid Haitham bin Tariq al Said on taking over as Sultan of Oman	“ಒಮನ್ ನ ದೊರೆಯಾಗಿ ಅಧಿಕಾರ ವಹಿಸಿಕೊಂಡಿರುವ ಸೈಯೀದ್ ಹೈಥಮ್ ಬಿನ್  ತಾರಿಖ್ ಅಲ್ ಸೈಯದ್ ಅವರನ್ನು ಹೃದಯ ಪೂರ್ವಕವಾಗಿ ಅಭಿನಂದಿಸುತ್ತೇನೆ.
I am confident that under his leadership, Oman will continue to progress and prosper and contribute to global peace.	ಅವರ ನಾಯಕತ್ವದಲ್ಲಿ ಒಮನ್ ನ ಪ್ರಗತಿ ಮತ್ತು ಅಭ್ಯುದಯ ಮುಂದುವರಿಯುವುದಲ್ಲದೆ, ಜಾಗತಿಕ ಶಾಂತಿಗೆ ಕೊಡುಗೆ ನೀಡಲಿದೆ ಎಂಬ ಭರವಸೆ ನನಗಿದೆ.
Citizenship Amendment Act is not a law to take away citizenship, it is a law to grant citizenship : PM	ಪೌರತ್ವ ತಿದ್ದುಪಡಿ ಕಾಯ್ದೆ, ಕಸಿದು ಕೊಳ್ಳುವ ಕಾನೂನಲ್ಲ, ಬದಲಿಗೆ ಪೌರತ್ವ ನೀಡುವ ಕಾನೂನು: ಪ್ರಧಾನಮಂತ್ರಿ
Prime Minister Shri Narendra Modi attended the 150th anniversary celebration of Kolkata Port Trust in Kolkata today	ಕೋಲ್ಕತ್ತಾ ಬಂದರು ಟ್ರಸ್ಟ್ ನ 150ನೇ ವಾರ್ಷಿಕೋತ್ಸವದಲ್ಲಿ ಪಾಲ್ಗೊಂಡ ಪ್ರಧಾನಮಂತ್ರಿ
PM also announced Kolkata Port Trust to be named after Dryama Prasad Mukherjee	ಕೋಲ್ಕತ್ತಾ ಬಂದರು ಟ್ರಸ್ಟ್ ಗೆ ಪ್ರಧಾನಮಂತ್ರಿಯವರಿಂದ ಡಾ ್ಯಾಮಾ ಪ್ರಸಾದ್ ಮುಖರ್ಜಿ ಬಂದರು ಟ್ರಸ್ಟ್ ಎಂದು ಪುನರ್ ನಾಮಕರಣ,
Telephone conversation of the Prime Minister with the President of the Russian Federation	ರಷ್ಯಾ ಒಕ್ಕೂಟದ ಅಧ್ಯಕ್ಷರೊಂದಿಗೆ ಪ್ರಧಾನಮಂತ್ರಿಯವರ ದೂರವಾಣಿ ಸಂಭಾಷಣೆ
Prime Minister Shri Narendra Modi and the President of the Russian Federation Mradimir Vladimirovich Putin had a telephone conversation today.	ಪ್ರಧಾನಮಂತ್ರಿ ಶ್ರೀ ನರೇಂದ್ರ ಮೋದಿ ಮತ್ತು ರಷ್ಯಾ ಒಕ್ಕೂಟದ ಅಧ್ಯಕ್ಷ ಶ್ರೀ ವ್ಲಾದಿಮಿರ್ ವ್ಲಾದಿಮಿರೋವಿಚ್ ಪುಟಿನ್ ಇಂದು ದೂರವಾಣಿ ಮೂಲಕ ಸಂಭಾಷಣೆ ನಡೆಸಿದರು.
Recalling that the Russian Federation had celebrated Christmas recently as per the tradition in Russia, the Prime Minister conveyed seasons greetings to President Putin and to the friendly people of Russia	ರಷ್ಯಾದ ಸಂಪ್ರದಾಯದಂತೆ ಇತ್ತೀಚೆಗೆ ರಷ್ಯಾ ಒಕ್ಕೂಟ ಕ್ರಿಸ್ಮಸ್ ಆಚರಿಸಿದ್ದನ್ನು ಸ್ಮರಿಸಿದ ಪ್ರಧಾನಮಂತ್ರಿಯವರು ಅಧ್ಯಕ್ಷ ಪುಟಿನ್ ಹಾಗೂ ರಷ್ಯಾದ ಸ್ನೇಹಪರ ಜನತೆಗೆ ಶುಭಾಶಯ ಸಲ್ಲಿಸಿದರು.
President Putin warmly reciprocated the greetings and wished Prime Minister Modi and the people of India prosperity, progress, peace and happiness.	ಅದೇ ರೀತಿ ರಷ್ಯಾ ಅಧ್ಯಕ್ಷ ಪುಟಿನ್ ಅವರು ಕೂಡ ಮೋದಿ ಹಾಗೂ ಭಾರತದ ಜನತೆಗೆ ಸುಖ, ಶಾಂತಿ, ಸಮೃದ್ಧಿ ಸಿಗಲೆಂದು ಶುಭ ಹಾರೈಸಿದರು.
The two leaders expressed happiness at the significant landmarks the Special Privileged Strategic Partnership between the two countries had covered in the recent past, particularly in the year 2019	ಇತ್ತೀಚಿನ ದಿನಗಳಲ್ಲಿ, ಅದರಲ್ಲೂ ವಿಶೇಷವಾಗಿ 2019 ರಲ್ಲಿ ಉಭಯ ದೇಶಗಳ ನಡುವಿನ ವಿಶೇಷ ಸೌಲಭ್ಯ ಪಡೆದ ವ್ಯೂಹಾತ್ಮಕ ಸಹಭಾಗಿತ್ವವು ಮೂಡಿಸಿದ ಮಹತ್ವದ ಹೆಗ್ಗುರುತುಗಳ ಬಗ್ಗೆ ಉಭಯ ನಾಯಕರು ಹರ್ಷ ವ್ಯಕ್ತಪಡಿಸಿದರು.
They agreed to continue consulting closely and working assiduously to further strengthen India-Russia ties in all spheres the year 2020	2020ರಲ್ಲಿ ಕೂಡ ಎಲ್ಲ ಕ್ಷೇತ್ರಗಳಲ್ಲಿ ಭಾರತ-ರಷ್ಯಾ ಬಾಂಧವ್ಯವನ್ನು ಮತ್ತಷ್ಟು ಬಲಪಡಿಸಲು ನಿಖಟವಾಗಿ ಸಮಾಲೋಚಿಸಲು ಮತ್ತು ಆಪ್ತವಾಗಿ ಶ್ರಮಿಸಲು ಸಮ್ಮತಿಸಿದರು.
The Prime Minister stressed that the year 2020 would be of special significance for Russia, and recalled with gratitude the invitation of President Putin to the Prime Minister to participate in the 75th Victory Day Celebration in Moscow in May this yearhe Prime Minister stated that he looked forward also to participating in the Summits of the Shanghai Cooperation Organization and the BRICS countries in Russia this year, and welcoming President Putin in India for the 21st bilateral Annual Summit.	2020ನೇ ವರ್ಷ ರಷ್ಯಾಕ್ಕೆ ವಿಶೇಷ ಮಹತ್ವದ್ದಾಗಿದೆ ಎಂದು ಒತ್ತಿ ಹೇಳಿದ ಪ್ರಧಾನಮಂತ್ರಿಯವರು, ಈ ವರ್ಷ ಮೇ ತಿಂಗಳಲ್ಲಿ ಮಾಸ್ಕೋದಲ್ಲಿ ನಡೆಯಲಿರುವ 75ನೇ ವಿಜಯ ದಿನದ ಆಚರಣೆಯಲ್ಲಿ ಭಾಗವಹಿಸುವಂತೆ ತಮಗೆ ಅಧ್ಯಕ್ಷ ಪುಟಿನ್ ಅವರು ನೀಡಿರುವ ಆಹ್ವಾನವನ್ನು ಕೃತಜ್ಞತೆಯಿಂದ ಸ್ಮರಿಸಿದರು.
The two leaders exchanged views on regional and global issues and underlined the great similarity and convergence in the approaches of India and Russia for ensuring regional and global security, peace and stability.	ಇಬ್ಬರೂ ನಾಯಕರು ಪ್ರಾದೇಶಿಕ ಮತ್ತು ಅಂತಾರಾಷ್ಟ್ರೀಯ ವಿಚಾರಗಳ ಬಗ್ಗೆ ತಮ್ಮ ಅಭಿಪ್ರಾಯ ಹಂಚಿಕೊಂಡರು ಮತ್ತು ಪ್ರಾದೇಶಿಕ ಮತ್ತು ಜಾಗತಿಕ ಭದ್ರತೆ, ಶಾಂತಿ ಮತ್ತು ಸ್ಥಿರತೆ ಕುರಿತಂತೆ ಭಾರತ ಹಾಗೂ ರಷ್ಯಾ ನಡುವೆ ಇರುವ ಸಮಾನತೆ ಮತ್ತು ಒಮ್ಮತದ ನಿಲುವುಗಳ ಬಗ್ಗೆ ಒತ್ತಿ ಹೇಳಿದರು.
PM greets people on the occasion of Lohri	ಪ್ರಧಾನಮಂತ್ರಿಯಿಂದ ಜನತೆಗೆ ಲೋಹ್ರಿ ಹಬ್ಬದ ಶುಭಾಶಯ
The Prime Minister, Shri Narendra Modi has greeted the people on the occasion of Lohri.	ಲೋಹ್ರಿ ಹಬ್ಬದ ಆಚರಣೆಗೆ ಪ್ರಧಾನಮಂತ್ರಿ ಶ್ರೀ ನರೇಂದ್ರ ಮೋದಿ ಅವರು ಜನತೆಗೆ ಶುಭ ಕೋರಿದ್ದಾರೆ.
, the Prime Minister said.	ಸಂತಸ ಹಾಗೂ ಉಲ್ಲಾಸದ ಈ ಹಬ್ಬ ನಿಮ್ಮೆಲ್ಲರ ಬದುಕಿನಲ್ಲಿ ಸುಖ ಮತ್ತು ಸಮೃದ್ಧಿ ತರಲಿ”, ಎಂದು ಪ್ರಧಾನಮಂತ್ರಿ ಹೇಳಿದ್ದಾರೆ.
Says unprecedented efforts have been put in for Tamil Nadus Progress	ತಮಿಳುನಾಡಿನ ಪ್ರಗತಿಗೆ ನಿರೀಕ್ಷಿಸಲಸಾಧ್ಯ ಪ್ರಯತ್ನಗಳನ್ನು ನಡೆಸಿದೆ ಎಂದರು
Prime Minister Shri Narendra Modi today participated in the 50thAnniversary function of Tamil Magazine Thuglak at Chennai through Video Conference.	ಪ್ರಧಾನಮಂತ್ರಿ ಶ್ರೀ ನರೇಂದ್ರ ಮೋದಿ ಅವರು, ಚೆನ್ನೈನಲ್ಲಿ ಆಯೋಜಿಸಿದ್ದ ತಮಿಳು ಮ್ಯಾಗ್ ಜೈನ್ ತುಘಲಕ್ ನ 50ನೇ ವಾರ್ಷಿಕೋತ್ಸವ ಸಮಾರಂಭದಲ್ಲಿ ವಿಡಿಯೋ ಕಾನ್ಫರೆನ್ಸ್ ಮೂಲಕ ಭಾಗವಹಿಸಿದರು.
Referring to the dynamism of Tamil Nadu, the Prime Minster said the state had been guiding light for the nation for centuries.	ತಮಿಳುನಾಡಿನ ದಿಟ್ಟತನವನ್ನು ಉಲ್ಲೇಖಿಸಿ ಮಾತನಾಡಿದ ಪ್ರಧಾನಮಂತ್ರಿ ಅವರು, ಈ ರಾಜ್ಯ ಶತಮಾನಗಳಿಂದಲೂ ರಾಷ್ಟ್ರಕ್ಕೆ ದಾರಿ ದೀಪವಾಗಿದೆ ಎಂದರು.
In September last year, I had the honour of saying a few lines in Tamil during my United Nations addresse said	ಕಳೆದ ವರ್ಷ ಸೆಪ್ಟೆಂಬರ್ ನಲ್ಲಿ ನನ್ನ ವಿಶ್ವ ಸಂಸ್ಥೆಯ ಭಾಷಣದ ವೇಳೆ ಕೆಲವು ಸಾಲುಗಳನ್ನು ತಮಿಳು ಭಾಷೆಯಲ್ಲಿ ಹೇಳುವ ಗೌರವ ನನಗೆ ಸಿಕ್ಕಿತ್ತು” ಎಂದು ಹೇಳಿದರು.
Referring to the development of the state, the Prime Minister said that the Union Government is taking several steps like establishment of one of the two defence corridors in Tamil Nadu.	ರಾಜ್ಯದ ಪ್ರಗತಿಯನ್ನು ಉಲ್ಲೇಖಿಸಿದ ಪ್ರಧಾನಮಂತ್ರಿ ಅವರು, ಎರಡರಲ್ಲಿ ಒಂದು ರಕ್ಷಣಾ ಕಾರಿಡಾರ್ ಅನ್ನು ತಮಿಳುನಾಡಿನಲ್ಲಿ ಸ್ಥಾಪಿಸಲು ಕೇಂದ್ರ ಸರ್ಕಾರ ಹಲವು ಕ್ರಮಗಳನ್ನು ಕೈಗೊಂಡಿದೆ ಎಂದರು.
Textiles and Fisheries Sector boost	ಜವಳಿ ಮತ್ತು ಮೀನುಗಾರಿಕೆ ವಲಯಕ್ಕೆ ಉತ್ತೇಜನ
Prime Minister said that special efforts are being made for modernizing the textile sector in the State.	ಪ್ರಧಾನಮಂತ್ರಿ ಅವರು, ರಾಜ್ಯದಲ್ಲಿ ಜವಳಿ ವಲಯದ ಆಧುನೀಕರಣಕ್ಕೆ ವಿಶೇಷ ಪ್ರಯತ್ನಗಳನ್ನು ನಡೆಸಲಾಗುತ್ತಿದೆ ಎಂದು ಹೇಳಿದರು.
Financial assistance has been provided under the National Handloom Development programme	ರಾಷ್ಟ್ರೀಯ ಕೈಮಗ್ಗ ಅಭಿವೃದ್ಧಿ ಕಾರ್ಯಕ್ರಮದಡಿ ಹಣಕಾಸು ಸಹಾಯವನ್ನು ನೀಡಲಾಗುತ್ತಿದೆ.
Resources have been allocated for machinery modernisation as well.	ಆಧುನೀಕರಣಕ್ಕಾಗಿ ಯಂತ್ರೋಪಕರಣಗಳಿಗೆ ಸಂಪನ್ಮೂಲಗಳನ್ನು ಹಂಚಿಕೆ ಮಾಡಲಾಗಿದೆ” ಎಂದು ಹೇಳಿದರು.
Shri Narendra Modi said that the Government is also taking special steps for boosting the fisheries sector.	ಶ್ರೀ ನರೇಂದ್ರ ಮೋದಿ ಅವರು, ಮೀನುಗಾರಿಕೆ ವಲಯದ ಉತ್ತೇಜನಕ್ಕೆ ಕೇಂದ್ರ ಸರ್ಕಾರ ಹಲವು ವಿಶೇಷ ಕ್ರಮಗಳನ್ನು ಕೈಗೊಂಡಿದೆ ಎಂದರು.
Our focus is on technology, financial assistance and human resource development	“ನಮ್ಮ ಆದ್ಯತೆ ಇದೀಗ ತಂತ್ರಜ್ಞಾನ, ಹಣಕಾಸು ನೆರವು ಮತ್ತು ಮಾನವ ಸಂಪನ್ಮೂಲ ಅಭಿವೃದ್ಧಿಯಾಗಿದೆ.
Our fishermen have been linked with Kisan Credit Cards	ನಮ್ಮ ಮೀನುಗಾರರನ್ನು ಕಿಸಾನ್ ಕ್ರೆಡಿಟ್ ಕಾರ್ಡ್ ಜೊತೆ ಸಂಯೋಜಿಸಲಾಗಿದೆ.
New fishing harbours have been built for fishermen	ಮೀನುಗಾರರಿಗಾಗಿ ಹೊಸ ಮೀನುಗಾರಿಕೆ ಬಂದರುಗಳನ್ನು ಸ್ಥಾಪಿಸಲಾಗಿದೆ.
Help is being given for boat modernisation too.	ದೋಣಿಗಳ ಆಧುನೀಕರಣಕ್ಕೂ ಸಹಾಯವನ್ನು ನೀಡಲಾಗುತ್ತಿದೆ” ಎಂದು ಹೇಳಿದರು.
Prime Minister urged everyone to visit 15 places in India in the next two years	ಪ್ರಧಾನಮಂತ್ರಿಗಳು ಮುಂದಿನ ಎರಡು ವರ್ಷಗಳಲ್ಲಿ ದೇಶದ ಪ್ರತಿಯೊಬ್ಬ ಪ್ರಜೆಯೂ ಭಾರತದ 15 ಸ್ಥಳಗಳಿಗೆ ಭೇಟಿ ನೀಡುವಂತೆ ಕೋರಿದರು.
India has moved from 52nd to 34th position in the World Economic Forums Travel and Tourism Competitiveness rankings.	ವಿಶ್ವ ಆರ್ಥಿಕ ವೇದಿಕೆಯ ಪ್ರಯಾಣ ಮತ್ತು ಪ್ರವಾಸ ಸ್ಪರ್ಧಾತ್ಮಕ ಸೂಚ್ಯಂಕದಲ್ಲಿ ಭಾರತಕ್ಕೆ 34ನೆಯ ಶ್ರೇಯಾಂಕಕ್ಕೇರಿದೆ.
So has the foreign exchange earned from tourism he said.	ಇದರಿಂದಾಗಿ ಪ್ರವಾಸೋದ್ಯಮದಿಂದ ಹೆಚ್ಚಿನ ವಿದೇಶಿ ವಿನಿಮಯವನ್ನು ಗಳಿಸಲಾಗಿದೆ” ಎಂದು ಹೇಳಿದರು.
Prime Minister said, Now, as India enters a new decade, it is the very people of India, who will guide Indias growth trajectory and take it to new heights	ಪ್ರಧಾನಮಂತ್ರಿ ಅವರು, “ಭಾರತ ಇದೀಗ ಹೊಸ ದಶಕಕ್ಕೆ ದಾಪುಗಾಲು ಇಟ್ಟಿದೆ, ಭಾರತದ ಜನರು ಭಾರತದ ಪ್ರಗತಿಗಾಥೆಯನ್ನು ಮುನ್ನಡೆಸುತ್ತಿದ್ದಾರೆ ಮತ್ತು ಅವರು ಅದನ್ನು ಹೊಸ ಎತ್ತರಕ್ಕೆ ಕೊಂಡೊಯ್ಯಲಿದ್ದಾರೆ.
Whenever the people of India decided to do something, no force has been able to stop them.	ಭಾರತದ ಜನರು ಯಾವುದೇ ಒಂದು ಕೆಲಸವನ್ನು ಮಾಡಲು ನಿಶ್ಚಯಿಸಿದರೆ, ಯಾವುದೇ ಶಕ್ತಿ ಅದನ್ನು ತಡೆಯಲು ಸಾಧ್ಯವೇ ಇಲ್ಲ” ಎಂದು ಹೇಳಿದರು.
Foreign Minister of the Russian Federation Mrrgey Lavrov Calls on Prime Minister Shri Narendra Modi	ರಷ್ಯಾ ಒಕ್ಕೂಟದ ವಿದೇಶಾಂಗ ಸಚಿವ ಶ್ರೀ ಸರ್ಗೈ ಲಾವ್ರೊವ್ ಅವರಿಂದ ಪ್ರಧಾನಮಂತ್ರಿ ಶ್ರೀ ನರೇಂದ್ರ ಮೋದಿ ಭೇಟಿ
Mrrgey Lavrov, Foreign Minister of the Russian Federation who is on a visit to India to participate in the Raisina Dialogue, called on Prime Minister Shri Narendra Modi today.	ರೈಸಿನ ಮಾತುಕತೆಯಲ್ಲಿ ಭಾಗವಹಿಸುವ ಸಲುವಾಗಿ ಭಾರತಕ್ಕೆ ಭೇಟಿ ನೀಡಿರುವ ರಷ್ಯಾ ಒಕ್ಕೂಟದ ವಿದೇಶಾಂಗ ಸಚಿವ ಶ್ರೀ ಸರ್ಗೈ ಲಾವ್ರೊವ್ ಅವರು ಇಂದು ಪ್ರಧಾನಮಂತ್ರಿ ಶ್ರೀ ನರೇಂದ್ರ ಮೋದಿ ಅವರನ್ನು ಭೇಟಿ ಮಾಡಿದ್ದರು.
The Prime Minister warmly reciprocated, the greetings and conveyed his best wishes for peace and prosperity of the Russian people in the New Year.	ಪ್ರಧಾನಮಂತ್ರಿ ಅವರು ಪರಸ್ಪರ ಆತ್ಮೀಯವಾಗಿ ಸ್ಪಂದಿಸಿ, ಹೊಸ ವರ್ಷದಲ್ಲಿ ರಷ್ಯಾದ ಜನರು ಶಾಂತಿ ಮತ್ತು ಶ್ರೇಯೋಭಿವೃದ್ಧಿ ಹೊಂದಲಿ ಎಂದು ಶುಭಾಶಯಗಳನ್ನು ತಿಳಿಸುವಂತೆ ಕೋರಿದರು.
The Prime Minister referred to the wide-ranging conversation he had with President Putin over telephone on 13 January 2020, and noted the progress in the Special and Privileged Strategic Partnership between the two countries in the previous year.	ಪ್ರಧಾನಮಂತ್ರಿ ಅವರು 2020ರ ಜನವರಿ 13ರಂದು ಅಧ್ಯಕ್ಷ ವ್ಲಾಡಿಮಿರ್ ಪುಟಿನ್ ಅವರ ಜೊತೆ ದೂರವಾಣಿ ಮೂಲಕ ವಿಸ್ತೃತ ಸಮಾಲೋಚನೆ ನಡೆಸಿದ್ದನ್ನು ಉಲ್ಲೇಖಿಸಿದರು ಮತ್ತು ಕಳೆದ ವರ್ಷ ಉಭಯ ದೇಶಗಳ ನಡುವಿನ ವಿಶೇಷ ಮತ್ತು ವಿಶೇಷಾಧಿಕಾರ ಕಾರ್ಯತಂತ್ರ ಪಾಲುದಾರಿಕೆ ಪ್ರಗತಿಯನ್ನು ಉಲ್ಲೇಖಿಸಿದರು.
Foreign Minister Lavrov conveyed that President Putin looked forward to the visit of the Prime Minister to Russia in May 2020 to participate in the 75th Anniversary Celebration of the Victory Day, and in July 2020 for the BRICS and SCO Summits	ವಿದೇಶಾಂಗ ಸಚಿವ ಲಾವ್ರೊವ್, ಮೇ 2020ರಲ್ಲಿ ನಡೆಯಲಿರುವ ವಿಜಯೋತ್ಸವದ 75ನೇ ವಾರ್ಷಿಕೋತ್ಸವ ಮತ್ತು ಜುಲೈ 2020ರಲ್ಲಿ ನಡೆಯಲಿರುವ ಬ್ರಿಕ್ಸ್ ಮತ್ತು ಎಸ್ ಸಿ ಒ ಶೃಂಗಸಭೆಯಲ್ಲಿ ಪ್ರಧಾನಮಂತ್ರಿ ಅವರು ಭಾಗವಹಿಸಲಿರುವ ಭೇಟಿಯನ್ನು ಅಧ್ಯಕ್ಷ ಪುಟಿನ್ ಅವರು ಎದುರು ನೋಡುತ್ತಿದ್ದಾರೆ ಎಂಬ ಸಂದೇಶವನ್ನು ರವಾನಿಸಿದರು.
Prime Minister welcomed multiple occasions this year to meet President Putin, and said that he also looked forward to hosting President Putin in India for the Annual Bilateral Summit later this year.	ಪ್ರಧಾನಮಂತ್ರಿ ಅವರು, ಈ ವರ್ಷ ಅಧ್ಯಕ್ಷ ಪುಟಿನ್ ಅವರನ್ನು ಭೇಟಿಮಾಡಲು ಹಲವು ಸಂದರ್ಭಗಳು ಒದಗಿರುವುದನ್ನು ಸ್ವಾಗತಿಸಿದರು ಮತ್ತು ಈ ವರ್ಷಾಂತ್ಯದಲ್ಲಿ ಭಾರತದಲ್ಲಿ ನಡೆಯಲಿರುವ ವಾರ್ಷಿಕ ದ್ವಿಪಕ್ಷೀಯ ಶೃಂಗಸಭೆಗೆ ಅಧ್ಯಕ್ಷ ಪುಟಿನ್ ಅವರಿಗೆ ಆತಿಥ್ಯ ನೀಡಲು ತಾವೂ ಕೂಡ ಎದುರು ನೋಡುತ್ತಿರುವುದಾಗಿ ಹೇಳಿದರು.
He suggested that the year 2020, which is also the 20th anniversary year of the establishment of strategic partnership between India and the Russian Federation, should be the year of implementation of those decisions.	ಈ ವರ್ಷ 2020ರಲ್ಲಿ ಭಾರತ ಮತ್ತು ರಷ್ಯಾ ಒಕ್ಕೂಟದ ಕಾರ್ಯತಂತ್ರ ಪಾಲುದಾರಿಕೆ ಸ್ಥಾಪನೆಯ 20ನೇ ವಾರ್ಷಿಕೋತ್ಸವ ಆಚರಿಸಿಕೊಳ್ಳುತ್ತಿರುವ ಹಿನ್ನೆಲೆಯಲ್ಲಿ ‘ಈವರೆಗೆ ಕೈಗೊಂಡ ನಿರ್ಧಾರಗಳನ್ನು ಅನುಷ್ಠಾನಗೊಳಿಸುವ ವರ್ಷ’ ಎಂದು ಪರಿಗಣಿಸಬೇಕಾಗುತ್ತದೆ ಎಂದು ಸಲಹೆ ನೀಡಿದರು.
Foreign Minister Lavrov briefed the Prime Minister on Russias position on key international and regional issues.	ವಿದೇಶಾಂಗ ಸಚಿವ ಲಾವ್ರೊವ್, ಪ್ರಮುಖ ಅಂತಾರಾಷ್ಟ್ರೀಯ ಮತ್ತು ಪ್ರಾದೇಶಿಕ ವಿಷಯಗಳ ಕುರಿತು ರಷ್ಯಾದ ನಿಲುವಿನ ಬಗ್ಗೆ ಪ್ರದಾನಮಂತ್ರಿ ಅವರಿಗೆ ವಿವರಿಸಿದರು.
Foreign Minister of the Islamic Republic of Iran Drvad ZarifCalls on Prime Minister Shri Narendra Modi	ಇರಾನ್ ಇಸ್ಲಾಮಿಕ್ ಗಣರಾಜ್ಯದ ವಿದೇಶಾಂಗ ಸಚಿವ ಜಾವೆದ್ ಜರೀಫ್ ಅವರಿಂದ ಪ್ರಧಾನಮಂತ್ರಿ ಶ್ರೀ ನರೇಂದ್ರ ಮೋದಿ ಭೇಟಿ
He reiterated Indias continued commitment to developing her strong and friendly relations with Iran	ಪ್ರಧಾನಿ ಅವರು, ಇರಾನ್ ಜೊತೆಗಿನ ಬಲಿಷ್ಠ ಮತ್ತು ಸ್ನೇಹ ಸಂಬಂಧಗಳನ್ನು ಅಭಿವೃದ್ಧಿಗೊಳಿಸಲು ಭಾರತದ ಬದ್ಧತೆ ಮುಂದುವರಿಯಲಿದೆ ಎಂದು ಪುನರುಚ್ಚರಿಸಿದರು.
The Foreign Minister shared his perspectives on the recent developments in the region	ವಿದೇಶಾಂಗ ಸಚಿವರು ಪ್ರಾಂತ್ಯದಲ್ಲಿನ ಇತ್ತೀಚಿನ ಬೆಳವಣಿಗೆಗಳನ್ನು ಕುರಿತು ತಮ್ಮ ಅನಿಸಿಕೆಗಳನ್ನು ಹಂಚಿಕೊಂಡರು.
The Prime Minister mentioned Indias strong interest in peace, security and stability in the region.	ಪ್ರಧಾನಮಂತ್ರಿ ಅವರು, ಪ್ರಾಂತ್ಯದಲ್ಲಿ ಸ್ಥಿರತೆ, ಶಾಂತಿ ಮತ್ತು ಸುರಕ್ಷತೆಗೆ ಭಾರತ ಬಲವಾದ ಆಸಕ್ತಿ ಹೊಂದಿದೆ ಎಂದು ಪ್ರಸ್ತಾಪಿಸಿದರು.
PM salutes the courage and valour of Indian Army personnel	ಭಾರತೀಯ ಸೇನಾ ಸಿಬ್ಬಂದಿಯ ಧೈರ್ಯ ಮತ್ತು ಶೌರ್ಯಕ್ಕೆ ಪ್ರಧಾನಮಂತ್ರಿ ನಮನ
The Prime Minister, Shri Narendra Modi has saluted the courage and valour of the Indian Army personnel on the occasion of Army Day	ಪ್ರಧಾನಮಂತ್ರಿ ಶ್ರೀ ನರೇಂದ್ರ ಮೋದಿ ಅವರು, ಸೇನಾ ದಿನದ ಅಂಗವಾಗಿ ಭಾರತೀಯ ಸೇನಾ ಸಿಬ್ಬಂದಿಯ ಧೈರ್ಯ ಹಾಗೂ ಶೌರ್ಯಕ್ಕೆ ನಮನ ಸಲ್ಲಿಸಿದರು.
Mrgars Rinkevics, Minister of Foreign Affairs of Latvia, Mrdulaziz Kamilov, Minister of Foreign Affairs of Uzbekistan, Mrter Szijjarto, Minister of Foreign Affairs and Trade of Hungary, Drmdullah Mohib, National Security Advisor of Afghanistan, Mrmas Petricek, Minister of Foreign Affairs of Czech Republic, Mrdulla Shahid, Minister of Foreign Affairs of Maldives, Drsan Mahmud, Minister of Information of Bangladesh, Mrmas Reinsalu, Minister of Foreign Affairs of Estonia, Drledi Pandor, Minister of International Relations and Cooperation of South Africa, Mrppe Kofod, Minister of Foreign Affairs of Denmark, Mstricia Scotland, Secretary General of The Commonwealth, Mradimir Norov, Secretary General of the Shanghai Cooperation Organisation, were the delegates who called on the Prime Minister.	12 ದೇಶಗಳ ಸಚಿವರ ಮಟ್ಟದ ಪ್ರತಿನಿಧಿಗಳು ರೈಸಿನಾ ಮಾತುಕತೆಯ ಸಂದರ್ಭದಲ್ಲಿ ಪ್ರಧಾನಿ ಶ್ರೀ ನರೇಂದ್ರ ಮೋದಿಯವರನ್ನು ಇಂದು ಅವರ ನಿವಾಸದಲ್ಲಿ ಭೇಟಿ ಮಾಡಿದರು ಾಟ್ವಿಯಾದ ವಿದೇಶಾಂಗ ವ್ಯವಹಾರಗಳ ಸಚಿವ ಶ್ರೀ ಎಡ್ಗರ್ಸ್ ರಿಂಕೆವಿಕ್ಸ್, ಉಜ್ಬೇಕಿಸ್ತಾನ್ ವಿದೇಶಾಂಗ ವ್ಯವಹಾರಗಳ ಸಚಿವ ಶ್ರೀ ಅಬ್ದುಲಜೀಜ್ ಕಮಿಲೋವ್, ಹಂಗೇರಿಯ ವಿದೇಶಾಂಗ ವ್ಯವಹಾರ ಮತ್ತು ವ್ಯಾಪಾರ ಸಚಿವ ಶ್ರೀ ಪೀಟರ್ ಸಿಜ್ಜಾರ್ಟೊ, ಅಫ್ಘಾನಿಸ್ತಾನದ ರಾಷ್ಟ್ರೀಯ ಭದ್ರತಾ ಸಲಹೆಗಾರ ಡಾ ಮ್ದುಲ್ಲಾ ಮೊಹಿಬ್, ಜೆಕ್ ಗಣರಾಜ್ಯದ ವಿದೇಶಾಂಗ ವ್ಯವಹಾರಗಳ ಸಚಿವ ತೋಮಸ್ ಪೆಟ್ರಿಸೆಕ್, ಮಾಲ್ಡೀವ್ಸ್ ವಿದೇಶಾಂಗ ವ್ಯವಹಾರಗಳ ಸಚಿವ ಶ್ರೀ ಅಬ್ದುಲ್ಲಾ ಶಾಹಿದ್, ಬಾಂಗ್ಲಾದೇಶದ ಮಾಹಿತಿ ಸಚಿವ ಡಾ ಸನ್ ಮಹಮೂದ್, ಎಸ್ಟೋನಿಯಾದ ವಿದೇಶಾಂಗ ವ್ಯವಹಾರಗಳ ಸಚಿವ ಶ್ರೀ ಉರ್ಮಾಸ್ ರೀನ್ಸಲು, ದಕ್ಷಿಣ ಆಫ್ರಿಕಾದ ಅಂತರರಾಷ್ಟ್ರೀಯ ಸಂಬಂಧ ಮತ್ತು ಸಹಕಾರ ಸಚಿವ ಡಾ ಲೇದಿ ಪಂಡೋರ್, ಡೆನ್ಮಾರ್ಕ್‌ನ ವಿದೇಶಾಂಗ ವ್ಯವಹಾರಗಳ ಸಚಿವ ಶ್ರೀ ಜೆಪ್ಪೆ ಕೊಫೊಡ್, ಕಾಮನ್‌ವೆಲ್ತ್‌ ಪ್ರಧಾನ ಕಾರ್ಯದರ್ಶಿ ಶ್ರೀಮತಿ ಪೆಟ್ರೀಷಿಯಾ ಸ್ಕಾಟ್ಲೆಂಡ್, ಶಾಂಘೈ ಸಹಕಾರ ಸಂಸ್ಥೆಯ ಪ್ರಧಾನ ಕಾರ್ಯದರ್ಶಿ ವ್ಲಾಡಿಮಿರ್ ನೊರೊವ್ ಅವರು ಪ್ರಧಾನ ಮಂತ್ರಿಯನ್ನು ಭೇಟಿ ಮಾಡಿದರು.
Prime Minister addresses at the international conclave on Globalizing Indian Thought at Kozhikode through video conference.	ಕೋಝಿಕೋಡ್ ನಲ್ಲಿ ನಡೆದ “ಭಾರತೀಯ ಚಿಂತನೆಗಳ ಜಾಗತೀಕರಣ” ಅಂತಾರಾಷ್ಟ್ರೀಯ ಸಮಾವೇಶವನ್ನುದ್ದೇಶಿಸಿ  ವಿಡಿಯೋ ಕಾನ್ಫರೆನ್ಸ್ ಮೂಲಕ ಪ್ರಧಾನಮಂತ್ರಿ ಭಾಷಣ
Prime Minister Shri Narendra Modi today unveiled a life size statue of Swami Vivekananda at IIM Kozhikode through video conference.	ಪ್ರಧಾನಮಂತ್ರಿ ಶ್ರೀ ನರೇಂದ್ರ ಮೋದಿ ಅವರು, ವಿಡಿಯೋ ಕಾನ್ಫರೆನ್ಸ್ ಮೂಲಕ ಐಐಎಂ ಕೋಝಿಕೋಡ್ ನಲ್ಲಿನ ಸ್ವಾಮಿ ವಿವೇಕಾನಂದರ ಆಳೆತ್ತರದ ದೊಡ್ಡ ಪ್ರತಿಮೆಯನ್ನು ಇಂದು ಅನಾವರಣಗೊಳಿಸಿದರು.
He was participating in the international conclave on Global Indian Thought that is being organised by IIM Kozhikode.	ಐಐಎಂ ಕೋಝಿಕೋಡ್ ಆಯೋಜಿಸಿದ್ದ ‘ಭಾರತೀಯ ಚಿಂತನೆಗಳ ಜಾಗತೀಕರಣ’ ಕುರಿತ ಅಂತಾರಾಷ್ಟ್ರೀಯ ಸಮಾವೇಶದಲ್ಲಿ ಅವರು ಭಾಗವಹಿಸಿದ್ದರು.
Addressing the gathering the Prime Minister said, Indian thought is vibrant and diverset is constant and evolving	ಸಭಿಕರನ್ನುದ್ದೇಶಿಸಿ ಭಾಷಣ ಮಾಡಿದ ಪ್ರಧಾನಮಂತ್ರಿ ಅವರು, “ಭಾರತೀಯರ ಚಿಂತನೆಗಳು ಪ್ರಕರವಾಗಿವೆ ಮತ್ತು ವಿಭಿನ್ನವಾಗಿವೆ.
They are- compassion, harmony, justice, service and openness.	ಅವುಗಳೆಂದರೆ ಅನುಕಂಪ, ಸೌಹಾರ್ದತೆ, ನ್ಯಾಯ, ಸೇನೆ ಮತ್ತು ಮುಕ್ತತೆ’’.
He said because of harmony and peace our civilization prospered and survived where many have failed.	ಸೌಹಾರ್ದತೆ ಮತ್ತು ಶಾಂತಿಯ ಕಾರಣದಿಂದಾಗಿ ನಮ್ಮ ನಾಗರಿಕತೆ ಏಳಿಗೆ ಸಾಧಿಸಿದೆ ಮತ್ತು ಹಲವರು ವಿಫಲರಾದಾಗ ನಾವು ನಾವು ಬದುಕುಳಿದಿದ್ದೇವೆ ಎಂದು ಹೇಳಿದರು.
So many states so many languages, so many dialects, so many faiths, so many customs and traditions, so many food habits so many lifestyles, so many ways of dressing	“ಹಲವು ರಾಜ್ಯಗಳಿವೆ, ಹಲವು ಭಾಷೆಗಳಿವೆ, ಹಲವು ಉಪಭಾಷೆಗಳಿವೆ, ಹಲವು ನಂಬಿಕೆಗಳು, ಹಲವು ಸಂಪ್ರದಾಯ ಮತ್ತು ಪರಂಪರೆಗಳು ಹಲವಾರು ಹವ್ಯಾಸಗಳು, ಹಲವು ಬಗೆಯ ಜೀವನಶೈಲಿ ಹಲವು ವಿಧದಲ್ಲಿ ಬಟ್ಟೆ ತೊಡುವುದು.
Yet, for centuries we have lived in peace	ಆದರೂ ನಾವು ಶತಮಾನಗಳಿಂದಲೂ ಶಾಂತಿಯಿಂದ ಬಾಳ್ವೆ ನಡೆಸುತ್ತಿದ್ದೇವೆ.
For centuries we have welcomed the world to our land	ಶತಮಾನಗಳಿಂದಲೂ ನಾವು ನಮ್ಮ ಭೂಮಿಗೆ ವಿಶ್ವವನ್ನು ಸ್ವಾಗತಿಸುತ್ತಿದ್ದೇವೆ.
Our civilisation has prospered when many could not	ಹಲವರಿಂದ ಸಾಧ್ಯವಾಗದಿದ್ದ ಸಂದರ್ಭದಲ್ಲಿ ನಮ್ಮ ನಾಗರಿಕತೆ ಪ್ರಗತಿ ಕಂಡಿದೆ.
Because one finds peace and harmony here.	ಏಕೆಂದರೆ ನಾವು ಇಲ್ಲಿ ಶಾಂತಿ ಮತ್ತು ಸೌಹಾರ್ದತೆಯನ್ನು ಕಾಣಬಹುದಾಗಿದೆ”.
In this land the Sufism flourished, he said.	“ಸೂಫಿ ಪಂಥವೂ ಈ ನೆಲದಲ್ಲಿ ಬೆಳಗಿತು” ಎಂದು ಹೇಳಿದರು.
Saying that Non-Violence is at the core of all these, he said Mahatma Gandhi championed these ideals that led to Indias freedom.	ಈ ಎಲ್ಲ ಧರ್ಮಗಳಿಗೆ ಅಹಿಂಸೆಯೇ ಮೂಲಮಂತ್ರವಾಗಿದೆ ಎಂದ ಅವರು, ಮಹಾತ್ಮ ಗಾಂಧೀಜಿ ಅವರು ಈ ಆದರ್ಶಗಳನ್ನು ಮುಂದಿಟ್ಟುಕೊಂಡು ಹೋರಾಟ ನಡೆಸಿ, ಭಾರತಕ್ಕೆ ಸ್ವಾತಂತ್ರ್ಯವನ್ನು ತಂದುಕೊಟ್ಟರು ಎಂದು ಹೇಳಿದರು.
The Indian way of conflict avoidance is not by brute force but the power of dialogue, he said.	‘ಸಂಘರ್ಷಗಳನ್ನು ತಪ್ಪಿಸುವ ಭಾರತೀಯ ಹಾದಿ ಎಂದರೆ ಶಕ್ತಿಯನ್ನು ತಡೆಯುವುದು ಎಂದರ್ಥವಲ್ಲ, ಆದರೆ ಅದು ಸಂವಾದದ ಶಕ್ತಿ” ಎಂದು ಹೇಳಿದರು.
When I say India believes in peace and harmony, this includes harmony with Mother Nature and our environment, he said	“ಭಾರತ ಶಾಂತಿ ಮತ್ತು ಸೌಹಾರ್ದತೆಯಲ್ಲಿ ನಂಬಿಕೆ ಇರಿಸಿದೇ ಎಂದು ನಾನು ಹೇಳಿದರೆ ಅದರಲ್ಲಿ ಭೂತಾಯಿ ಮತ್ತು ನಮ್ಮ ಪರಿಸರದ ಜೊತೆಗಿನ ಸೌಹಾರ್ದತೆಯೂ ಇದೆ ಎಂದರ್ಥ” ಎಂದು ಹೇಳಿದರು.
He said India led the world in forming the International Solar Alliance, to harness solar energy for a cleaner tomorrow.	ಸ್ವಚ್ಛ ನಾಳೆಗಾಗಿ ಸೌರಶಕ್ತಿಯನ್ನು ಸಂಪೂರ್ಣವಾಗಿ ಬಳಕೆ ಮಾಡಿಕೊಳ್ಳುವ ‘ಅಂತಾರಾಷ್ಟ್ರೀಯ ಸೌರ ಮೈತ್ರಿ ರಚನೆಯಲ್ಲಿ ಭಾರತ ಇಡೀ ವಿಶ್ವವನ್ನು ಮುನ್ನಡೆಸಿತ್ತು’ ಎಂದು ಹೇಳಿದರು.
Prime Minister said in the last 5 years 36 Crore LED bulbs were distributed and over 1 Crore Street lights replaced with LED making a saving of Rs 25000 Crore and reducing CO2 emissions by 4 Crore Tonnes.	ಪ್ರಧಾನಮಂತ್ರಿ ಅವರು ಕಳೆದ 5 ವರ್ಷಗಳಲ್ಲಿ 36 ಕೋಟಿ ಎಲ್ಇಡಿ ಬಲ್ಬ್ ಗಳನ್ನು ವಿತರಿಸಲಾಗಿದೆ, ಮತ್ತು ಸುಮಾರು ಒಂದು ಕೋಟಿ ಬೀದಿ ದೀಪಗಳನ್ನು ಬದಲಿಸಿ, ಎಲ್ಇಡಿ ದೀಪ ಅಳವಡಿಸುವ ಮೂಲಕ 25000 ಕೋಟಿ ರೂ.
Protecting the Tiger and the Lion	ಹುಲಿ ಮತ್ತು ಸಿಂಹ ಸಂರಕ್ಷಣೆ
He said Indias tiger population doubled since 2006	ಭಾರತದಲ್ಲಿ 2006ರಿಂದೀಚೆಗೆ ಹುಲಿಗಳ ಸಂಖ್ಯೆ ದುಪ್ಪಟ್ಟಾಗಿದೆ ಎಂದರು.
Today, India is home to almost 2970 tigers	“ಇಂದು ಭಾರತ ಬಹುತೇಕ 2970 ಹುಲಿಗಳ ತವರೂರಾಗಿದೆ.
Three quarters of the worlds tiger population stays in India	ವಿಶ್ವದ ಹುಲಿ ಜನಸಂಖ್ಯೆಯ ಮೂರನೇ ಒಂದು ಭಾಗ ಭಾರತದಲ್ಲಿ ನೆಲೆಸಿವೆ.
We achieved it way in advance he said.	ನಾವು ಅದಕ್ಕೂ ಮುನ್ನವೇ ಗುರಿಯನ್ನು ಸಾಧಿಸಿದ್ದೇವೆ” ಎಂದು ಹೇಳಿದರು.
Similarly the lion population has grown up 30% from 2010 to 2015, he said.	ಅದೇ ರೀತಿ ಸಿಂಹಗಳ ಸಂಖ್ಯೆಯೂ 2010ರಿಂದ 2015ರ ನಡುವೆ ಶೇ.
Prime Minister also pointed out that the countrys forest cover is growing.	ಪ್ರಧಾನಮಂತ್ರಿ ಅವರು ದೇಶದಲ್ಲಿ ಅರಣ್ಯ ವ್ಯಾಪ್ತಿ ಹೆಚ್ಚಾಗುತ್ತಿರುವ ಅಂಶವನ್ನೂ ಪ್ರಸ್ತಾಪಿಸಿದರು.
The number of protected areas stood at 692 in 2014	“2014ರಲ್ಲಿ ಒಟ್ಟು ಸಂರಕ್ಷಿತ ಪ್ರದೇಶಗಳ ಸಂಖ್ಯೆ 692 ಇತ್ತು.
This increased to more than 860 in 2019	2019ರಲ್ಲಿ ಆ ಪ್ರಮಾಣ 860ಕ್ಕಿಂತಲೂ ಹೆಚ್ಚಾಗಿದೆ.
These facts are drawing many environment and wildlife lovers to India.	ಈ ಅಂಶಗಳು ಹಲವು ಪರಿಸರ ಮತ್ತು ವನ್ಯಜೀವಿ ಪ್ರೇಮಿಗಳನ್ನು ಭಾರತಕ್ಕೆ ಆಕರ್ಷಿಸುವಂತೆ ಮಾಡಿದೆ”.
He lauded the efforts of the Bhakti saints, Raja Ram Mohun Roy, Ishwar Chandra Vidyasagar, Mahatma Phule and Savitri Bai Phule in this direction.	ಪ್ರಧಾನಮಂತ್ರಿ ಅವರು, ಈ ನಿಟ್ಟಿನಲ್ಲಿ ಭಕ್ತಿ ಸಂತರು, ರಾಜಾರಾಮ್ ಮೋಹನ್ ರಾಯ್, ಈಶ್ವರ ಚಂದ್ರ ವಿದ್ಯಾಸಾಗರ, ಮಾಹಾತ್ಮ ಪುಲೆ ಮತ್ತು ಸಾವಿತ್ರಿ ಬಾಯಿ ಪುಲೆ ಅವರ ಕಾರ್ಯವನ್ನು ಶ್ಲಾಘಿಸಿದರು.
European High Representative/Vice President (HRVP) HJosep Borrell Fontelles Calls on Prime Minister Shri Narendra Modi	ಪ್ರಧಾನಮಂತ್ರಿ ಶ್ರೀ ನರೇಂದ್ರ ಮೋದಿಯವರನ್ನು ಭೇಟಿ ಮಾಡಿದ ಯುರೋಪ್ ಉನ್ನತ ಪ್ರತಿನಿಧಿ / ಉಪಾಧ್ಯಕ್ಷ (ಎಚ್‌ಆರ್‌ವಿಪಿ) ಘನತೆವೆತ್ತ ಜೋಸೆಫ್  ಬೊರೆಲ್ ಫಾಂಟೆಲ್ಸ್
European High Representative/Vice President (HRVP) HJosep Borrell Fontelles Calls on Prime Minister Shri Narendra Modi	ಯುರೋಪ್ ಉನ್ನತ ಪ್ರತಿನಿಧಿ/ ಉಪಾಧ್ಯಕ್ಷ (ಎಚ್ ರ್ ಿ ಿಘನತೆವೆತ್ತ ಜೋಸೆಪ್ ಬೋರೆಲ್ ಫಾಂಟೆಲ್ಸ್ ಅವರಿಂದು ಪ್ರಧಾನಮಂತ್ರಿ ಶ್ರೀ ನರೇಂದ್ರ ಮೋದಿ ಅವರನ್ನು ಭೇಟಿ ಮಾಡಿದರು.
Mrrrell is on a visit to India from Jan 16-18 to attend Raisina Dialogue 2020 where he delivered Valedictory Address yesterday	ಬೋರೆಲ್ ಅವರು ರೈಸಿನಾ ಸಂವಾದ 2020ರಲ್ಲಿ ಭಾಗಿಯಾಗಲು ಜನವರಿ 16-18ರವರೆಗೆ ಭಾರತ ಭೇಟಿ ಕೈಗೊಂಡಿದ್ದಾರೆ, ಅವರು ನಿನ್ನೆ ಅಲ್ಲಿ ಸಮಾರೋಪ ಭಾಷಣ ಮಾಡಿದರು.
This is his first visit outside the EU after he took over as HRVP on 01 December 2019	ಅವರು ಎಚ್ ರ್ ಿ ಿ ಾಗಿ 2019ರ ಡಿಸೆಂಬರ್ 1ರಂದು ಅಧಿಕಾರ ವಹಿಸಿಕೊಂಡ ತರುವಾಯ ಐರೋಪ್ಯ ಒಕ್ಕೂಟದ ಹೊರಗೆ ಕೈಗೊಂಡ ಪ್ರಥಮ ಭೇಟಿಯಾಗಿದೆ.
The Prime Minister also appreciated HRVPs regular participation in the Raisina Dialogue.	ಎಚ್ ರ್ ಿ ಿಗಳು ರೈಸಿನಾ ಸಂವಾದದಲ್ಲಿ ನಿರಂತರವಾಗಿ ಭಾಗಿಯಾಗುತ್ತಿರುವುದಕ್ಕೆ ಪ್ರಧಾನಮಂತ್ರಿಗಳು ಮೆಚ್ಚುಗೆ ವ್ಯಕ್ತಪಡಿಸಿದರು.
The Prime Minister conveyed that India and the European Union were natural partners and that he was looking forward to a productive India-EU Summit in March 2020	ಭಾರತ ಮತ್ತು ಐರೋಪ್ಯ ಒಕ್ಕೂಟಗಳು ಸ್ವಾಭಾವಿಕ ಸಹಯೋಗಿಗಳು ಎಂದು ತಿಳಿಸಿದ ಪ್ರಧಾನಮಂತ್ರಿಯವರು, ಮಾರ್ಚ್ 2020ರಲ್ಲಿ ಫಲಪ್ರದವಾದ ಭಾರತ – ಐರೋಪ್ಯ ಒಕ್ಕೂಟದ ಶೃಂಗಸಭೆಯನ್ನು ತಾವು ಎದಿರುನೋಡುತ್ತಿರುವುದಾಗಿ ತಿಳಿಸಿದರು.
The Prime Minister reiterated Indias commitment to deepen the engagement with the EU particularly in the fields of climate change, and trade and economic relationshe Prime Minister also recalled his earlier interactions with leadership of European Commission and European Council.	ಐರೋಪ್ಯ ಒಕ್ಕೂಟದೊಂದಿಗೆ ಅದರಲ್ಲೂ ಹವಾಮಾನ ಬದಲಾವಣೆ, ವಾಣಿಜ್ಯ ಮತ್ತು ಆರ್ಥಿಕ ಬಾಂಧವ್ಯದ ಕ್ಷೇತ್ರಗಳಲ್ಲಿ ಕಾರ್ಯಚಟುವಟಿಕೆಯನ್ನು ಮತ್ತಷ್ಟು ಆಳಗೊಳಿಸುವ ಬದ್ಧತೆಯನ್ನು ಪ್ರಧಾನಮಂತ್ರಿಯವರು ಪುನರುಚ್ಚರಿಸಿದರು.
He also dwelt on the shared priorities and commitment of EU and India, which include democracy, multilateralism and rules-based international order.	ಪ್ರಜಾಪ್ರಭುತ್ವ, ಬಹುಪಕ್ಷೀಯತೆ ಮತ್ತು ನಿಯಮ-ಆಧಾರಿತ ಅಂತಾರಾಷ್ಟ್ರೀಯ ಕ್ರಮವನ್ನು ಒಳಗೊಂಡಿರುವ ಐರೋಪ್ಯ ಒಕ್ಕೂಟ ಮತ್ತು ಭಾರತದ ಹಂಚಿಕೆಯ ಆದ್ಯತೆಗಳು ಮತ್ತು ಬದ್ಧತೆಯ ಬಗ್ಗೆಯೂ ಅವರು ಪ್ರಸ್ತಾಪಿಸಿದರು.
The Prime Minister, Shri Narendra Modi will interact with a cross section of Students, Teachers and Parents at Pariksha Pe Charcha 2020 on20th January, 2020	ಪ್ರಧಾನಮಂತ್ರಿ ಶ್ರೀ ನರೇಂದ್ರ ಮೋದಿ ಅವರು 2020ರ ಜನವರಿ 20ರಂದು “ಪರೀಕ್ಷಾ ಪೆ ಚರ್ಚಾ 2020”, ವಿದ್ಯಾರ್ಥಿಗಳು, ಶಿಕ್ಷಕರು ಹಾಗೂ ಪೋಷಕರೊಂದಿಗೆ ಸಂವಾದ ನಡೆಸುವರು.
The Third edition of Prime Ministers Interaction Programme with school students Pariksha Pe Charcha 2020is proposed to be held at Talkatora Stadium, New Delhi at 11 AM on 20th January, 2020	ಪ್ರಧಾನಮಂತ್ರಿಗಳು ಶಾಲಾ ವಿದ್ಯಾರ್ಥಿಗಳೊಂದಿಗೆ ಸಂವಾದ ನಡೆಸುವ ಮೂರನೇ ಆವೃತ್ತಿಯ ‘ಪರೀಕ್ಷಾ ಪೆ ಚರ್ಚಾ 2020’ ಕಾರ್ಯಕ್ರಮ, ನವದೆಹಲಿಯ ತಾಲ್ಕಟೋರ ಕ್ರೀಡಾಂಗಣದಲ್ಲಿ 2020ರ ಜನವರಿ 20ರಂದು ಬೆಳಗ್ಗೆ 11 ಗಂಟೆಗೆ ನಡೆಯಲಿದೆ.
Prime Minister, Shri Narendra Modiwill answer the questions and interact with selected students about how they can beat examination stress.	ಪ್ರಧಾನಮಂತ್ರಿ ಶ್ರೀ ನರೇಂದ್ರ ಮೋದಿ ಅವರು ಹೇಗೆ ಪರೀಕ್ಷಾ ಒತ್ತಡವನ್ನು ನಿಭಾಯಿಸುವುದು ಎನ್ನುವ ಕುರಿತು ಆಯ್ದ ವಿದ್ಯಾರ್ಥಿಗಳ ಪ್ರಶ್ನೆಗಳಿಗೆ ಉತ್ತರಿಸಿ, ಸಂವಾದ ನಡೆಸುವರು.
The First edition of Prime Ministers Interaction Programme with school and college students ParikshaPeCharcha 1was held at Talkatora Stadium, New Delhi on 16th February, 2018	ಶಾಲಾ ಮತ್ತು ಕಾಲೇಜು ವಿದ್ಯಾರ್ಥಿಗಳೊಂದಿಗೆ ಪ್ರಧಾನಮಂತ್ರಿಗಳ ಸಂವಾದ ಕಾರ್ಯಕ್ರಮ ‘ಪರೀಕ್ಷಾ ಪೆ ಚರ್ಚಾ 1 ಯ ಮೊದಲ ಆವೃತ್ತಿ 2018ರ ಫೆಬ್ರವರಿ 16ರಂದು ನವದೆಹಲಿಯ ತಾಲ್ಕಟೋರ ಸ್ಟೇಡಿಯಂನಲ್ಲಿ ನಡೆದಿತ್ತು.
The second edition of the said Interaction Programme with school and college students ParikshaPeCharcha 2as also held at Talkatora Stadium, New Delhi on 29th January, 2019	ಎರಡನೇ ಆವೃತ್ತಿ ಶಾಲಾ ಮತ್ತು ಕಾಲೇಜು ವಿದ್ಯಾರ್ಥಿಗಳ ಜೊತೆಗಿನ ಸಂವಾದ ಕಾರ್ಯಕ್ರಮ ‘ಪರೀಕ್ಷಾ ಪೆ ಚರ್ಚಾ 22019ರ ಜನವರಿ 29ರಂದು ನವದೆಹಲಿಯ ತಾಲ್ಕಟೋರ ಸ್ಟೇಡಿಯಂನಲ್ಲಿ ನಡೆದಿತ್ತು.
PM interacts with students, teachers and parents at Pariksha Pe Charcha 2.0	“ಪರೀಕ್ಷಾ ಪೆ ಚರ್ಚಾ 3 : ವಿದ್ಯಾರ್ಥಿಗಳು, ಶಿಕ್ಷಕರು ಮತ್ತು ಪೋಷಕರೊಂದಿಗೆ ಪ್ರಧಾನಿಯವರ ಸಂವಾದ
Explaining the importance of the decade, the Prime Minister said that the hopes and aspirations of the current decade rest on those students who are in their final years of schooling in the country.	ಈ ದಶಕದ ಪ್ರಾಮುಖ್ಯತೆಯನ್ನು ವಿವರಿಸಿದ ಅವರು, ಪ್ರಸ್ತುತ ದಶಕದ ಆಶಯಗಳು ಮತ್ತು ಆಕಾಂಕ್ಷೆಗಳು ದೇಶದಲ್ಲಿ ಅಂತಿಮ ವರ್ಷದ ಶಾಲಾ ಶಿಕ್ಷಣದಲ್ಲಿರುವ ಮಕ್ಕಳ ಮೇಲೆ ಅವಲಂಬಿತವಾಗಿವೆ ಎಂದರು.
To make the country reach new heights, to achieve new hopes, all this is dependent on this new generation.	ದೇಶವು ಹೊಸ ಎತ್ತರವನ್ನು ತಲುಪುವುದು, ಹೊಸ ಭರವಸೆಗಳನ್ನು ಸಾಧಿಸುವುದು ಈ ನವ ಪೀಳಿಗೆಯ ಮೇಲೆ ಅವಲಂಬಿತವಾಗಿದೆ ” ಎಂದು ಅವರು ಹೇಳಿದರು.
Replying to a question from a student about losing interest while studying, the Prime Minister said most often students get demotivated due to factors that are external to them and also as they try to attach too much significance to their own expectations.	ಅಧ್ಯಯನದಲ್ಲಿ ಆಸಕ್ತಿಯನ್ನು ಕಳೆದುಕೊಳ್ಳುವ ಕುರಿತ ವಿದ್ಯಾರ್ಥಿಯೊಬ್ಬನ ಪ್ರಶ್ನೆಗೆ ಪ್ರಧಾನ ಮಂತ್ರಿಯವರು ಉತ್ತರಿಸುತ್ತಾ, ಹೆಚ್ಚಾಗಿ ವಿದ್ಯಾರ್ಥಿಗಳು ತಮ್ಮ ಬಾಹ್ಯ ಕಾರಣಗಳಿಂದಾಗಿ ನಿರಾಸಕ್ತಿ ತಾಳುತ್ತಾರೆ ಮತ್ತು ಅವರು ತಮ್ಮದೇ ಆದ ನಿರೀಕ್ಷೆಗಳಿಗೆ ಹೆಚ್ಚಿನ ಪ್ರಾಮುಖ್ಯತೆಯನ್ನು ನೀಡಲು ಪ್ರಯತ್ನಿಸುತ್ತಾರೆ ಎಂದರು.
He gave the example of the recent issue of Chandrayaan and his visit to ISRO.	ಇತ್ತೀಚಿನ ಚಂದ್ರಯಾನ ಸಮಸ್ಯೆ ಮತ್ತು ಇಸ್ರೋಗೆ ತಮ್ಮ ಭೇಟಿಯನ್ನು ಉದಾಹರಣೆಯಾಗಿ ನೀಡಿದರು.
In this regard, I can never forget my visit to ISRO during Chandrayaan and the time spent with our hardworking scientists.	ಈ ನಿಟ್ಟಿನಲ್ಲಿ, ಚಂದ್ರಯಾನ ಸಮಯದಲ್ಲಿ ನಾನು ಇಸ್ರೋಗೆ ಭೇಟಿ ನೀಡಿದ್ದನ್ನು ಮತ್ತು ನಮ್ಮ ಕಠಿಣ ಪರಿಶ್ರಮದ ವಿಜ್ಞಾನಿಗಳೊಂದಿಗೆ ಕಳೆದ ಸಮಯವನ್ನು ನಾನು ಎಂದಿಗೂ ಮರೆಯಲು ಸಾಧ್ಯವಿಲ್ಲ.
We can add enthusiasm to every aspect of life	ನಾವು ಜೀವನದ ಪ್ರತಿಯೊಂದುಕ್ಕೂ ಉತ್ಸಾಹವನ್ನು ಸೇರಿಸಬಹುದು.
A temporary setback doesnt mean that we cannot succeed in life	ತಾತ್ಕಾಲಿಕ ಹಿನ್ನಡೆಯು ಜೀವನದಲ್ಲಿ ಯಶಸ್ಸು ಕಾಣಲು ಸಾಧ್ಯವಿಲ್ಲ ಎಂದರ್ಥವಲ್ಲ.
The Prime Minister also gave examples of how cricketers Rahul Dravid and V V S Laxman batted in difficult situations during IndiaAustralia match in 2001 to clinch victory for India from the jaws of defeat.	ಸೋಲಿನ ದವಡೆಯಿಂದ ಪಾರಾಗಿ ಭಾರತಕ್ಕೆ ಗೆಲುವು ದಕ್ಕಿಸಲು 2001 ರಲ್ಲಿ ಭಾರತ - ಆಸ್ಟ್ರೇಲಿಯಾ ಪಂದ್ಯದ ಸಂದರ್ಭದಲ್ಲಿ ಕ್ರಿಕೆಟಿಗರಾದ ರಾಹುಲ್ ದ್ರಾವಿಡ್ ಮತ್ತು ವಿ ವಿ ಎಸ್ ಲಕ್ಷ್ಮಣ್ ಅವರು ಹೇಗೆ ಬ್ಯಾಟಿಂಗ್ ಮಾಡಿದರು ಎಂಬುದನ್ನು ಪ್ರಧಾನಿ ಉದಾಹರಣೆಯಾಗಿ ನೀಡಿದರು.
He also talked about how India bowler Anil Kumble bowled to Indias glory notwithstanding his injury.	ಬೌಲರ್ ಅನಿಲ್ ಕುಂಬ್ಳೆ ತಾವು ಗಾಯಗೊಂಡಿದ್ದರೂ ಭಾರತದ ಗೆಲುವಿಗಾಗಿ ಹೇಗೆ ಬೌಲ್ ಮಾಡಿದರು ಎಂಬುದರ ಕುರಿತು ಅವರು ಮಾತನಾಡಿದರು.
This is the power of positive motivation, he said.	ಇದು ಸಕಾರಾತ್ಮಕ ಪ್ರೇರಣೆಯ ಶಕ್ತಿಎಂದು ಅವರು ಹೇಳಿದರು.
Balancing Extra- Curricular Activities and Studies:	ಪಠ್ಯೇತರ ಚಟುವಟಿಕೆಗಳು ಮತ್ತು ಅಧ್ಯಯನವನ್ನು ಸಮತೋಲನಗೊಳಿಸುವುದು:
To a question on how to balance studies and extracurricular activities, the Prime Minister said the importance of co-curricular activities in a students life cannot be understated.	ಅಧ್ಯಯನ ಮತ್ತು ಪಠ್ಯೇತರ ಚಟುವಟಿಕೆಗಳನ್ನು ಹೇಗೆ ಸಮತೋಲನಗೊಳಿಸುವುದು ಹೇಗೆ ಎಂಬ ಪ್ರಶ್ನೆಗೆ, ವಿದ್ಯಾರ್ಥಿಯ ಜೀವನದಲ್ಲಿ ಪಠ್ಯೇತರ ಚಟುವಟಿಕೆಗಳ ಮಹತ್ವವನ್ನು ಅಲ್ಲಗಳೆಯಲು ಸಾಧ್ಯವಿಲ್ಲ ಎಂದು ಪ್ರಧಾನಿ ಹೇಳಿದರು.
Extra-curricular activities neednt be glamour driven	ಪಠ್ಯೇತರ ಚಟುವಟಿಕೆಗಳು ಗ್ಲಾಮರ್ ಚಾಲಿತವಾಗಬೇಕಿಲ್ಲ.
Let each child pursue what he or she likes, he said.	ಪ್ರತಿ ಮಗುವೂ ತಾನು ಇಷ್ಟಪಡುವುದನ್ನು ಮುಂದುವರಿಸಲಿ ” ಎಂದು ಅವರು ಹೇಳಿದರು.
Saying that there are several opportunities today, he asked the students to come out of the feeling that success or failure at exams determines everything.	ಇಂದು ಹಲವಾರು ಅವಕಾಶಗಳಿವೆ ಎಂದು ಹೇಳಿದ ಅವರು, ಪರೀಕ್ಷೆಗಳಲ್ಲಿನ ಯಶಸ್ಸು ಅಥವಾ ವೈಫಲ್ಯವು ಎಲ್ಲವನ್ನೂ ನಿರ್ಧರಿಸುತ್ತದೆ ಎಂಬ ಭಾವನೆಯಿಂದ ಹೊರಬರಬೇಕು ಎಂದು ಅವರು ವಿದ್ಯಾರ್ಥಿಗಳಿಗೆ ಹೇಳಿದರು“ಅಂಕಗಳೇ ಜೀವನವಲ್ಲ.
Similarly examination is not the determining factor for our whole life	ಅದೇ ರೀತಿ ಪರೀಕ್ಷೆ ಸಹ ನಮ್ಮ ಇಡೀ ಜೀವನವನ್ನು ನಿರ್ಧರಿಸುವ ಅಂಶವಲ್ಲ.
I pray to parents dont tell them that this is everything	ಸರ್ವಸ್ವವೂ ಅದೇ ಎಂದು ಹೇಳಬೇಡಿ ಎಂದು ಪೋಷಕರಿಗೆ ಎಂದು ನಾನು ಮನವಿ ಮಾಡುತ್ತೇನೆ.
You can go to any field	ನೀವು ಯಾವುದೇ ಕ್ಷೇತ್ರದಲ್ಲಾದರೂ ಸಾಧಿಸಬಹುದು.
There are umpteen opportunities, he said.	ನಿಮಗೆ ವಿಫುಲ ಅವಕಾಶಗಳಿವೆ ”ಎಂದು ಅವರು ಹೇಳಿದರು.
Exams are important, but exams are not life	ಪರೀಕ್ಷೆಗಳು ಮುಖ್ಯ, ಆದರೆ ಪರೀಕ್ಷೆಗಳೇ ಜೀವನವಲ್ಲ.
You should come out of this mind-set, he said.	ಈ ಮನಸ್ಥಿತಿಯಿಂದ ನೀವು ಹೊರಬರಬೇಕು ಎಂದು ಅವರು ಹೇಳಿದರು.
Fear of technology is not good	“ತಂತ್ರಜ್ಞಾನದ ಬಗೆಗಿನ ಭಯ ಒಳ್ಳೆಯದಲ್ಲ.
Merely knowledge of technology isnt enough	ಕೇವಲ ತಂತ್ರಜ್ಞಾನದ ಜ್ಞಾನವು ಸಾಕಾಗುವುದಿಲ್ಲ.
Technology is a part of our daily lives, but if we misuse it, it robs our valuable time and resources, he said.	ತಂತ್ರಜ್ಞಾನವು ನಮ್ಮ ದೈನಂದಿನ ಜೀವನದ ಒಂದು ಭಾಗವಾಗಿದೆ, ಆದರೆ ನಾವು ಅದನ್ನು ದುರುಪಯೋಗಪಡಿಸಿಕೊಂಡರೆ ಅದು ನಮ್ಮ ಅಮೂಲ್ಯವಾದ ಸಮಯ ಮತ್ತು ಸಂಪನ್ಮೂಲಗಳನ್ನು ಕಸಿದುಕೊಳ್ಳುತ್ತದೆ ”ಎಂದು ಅವರು ಹೇಳಿದರು.
To a question on what are the rights of the students and on how to make the citizens aware of their duties, the Prime Minister said that an individuals rights are embedded in his duties.	ವಿದ್ಯಾರ್ಥಿಗಳ ಹಕ್ಕುಗಳು ಯಾವುವು ಮತ್ತು ಜನರಿಗೆ ತಮ್ಮ ಕರ್ತವ್ಯಗಳ ಬಗ್ಗೆ ಅರಿವು ಮೂಡಿಸುವುದು ಹೇಗೆ ಎಂಬ ಪ್ರಶ್ನೆಗೆ ಉತ್ತರಿಸಿದ ಪ್ರಧಾನಿಯವರು, ವ್ಯಕ್ತಿಯ ಹಕ್ಕುಗಳು ಅವನ ಕರ್ತವ್ಯಗಳಲ್ಲಿಯೇ ಅಡಗಿರುತ್ತವೆ ಎಂದು ಹೇಳಿದರು.
Giving an example of a teacher, he said, if a teacher performs his duties then he is fulfilling the rights of the students.	ಶಿಕ್ಷಕರ ಉದಾಹರಣೆ ನೀಡಿದ ಅವರು, ಒಬ್ಬ ಶಿಕ್ಷಕ ತನ್ನ ಕರ್ತವ್ಯಗಳನ್ನು ನಿರ್ವಹಿಸಿದರೆ ಅವನು ವಿದ್ಯಾರ್ಥಿಗಳ ಹಕ್ಕುಗಳನ್ನು ಪೂರೈಸುತ್ತಿದ್ದಾನೆ ಎಂದರ್ಥ ಎಂದರು.
Referring to what the Father of the Nation opined on the issue, the Prime Minister said, Mahatma Gandhi said that there are no fundamental rights but fundamental duties.	ರಾಷ್ಟ್ರಪಿತ ಗಾಂಧೀಜಿಯವರು ಈ ವಿಷಯದ ಬಗ್ಗೆ ಪ್ರಸ್ತಾಪಿಸಿದ್ದನ್ನು ಉಲ್ಲೇಖಿಸಿದ ಪ್ರಧಾನಿಯವರು, “ಮಹಾತ್ಮ ಗಾಂಧಿಯವರು ಮೂಲಭೂತ ಕರ್ತವ್ಯಗಳಿಲ್ಲದೆ ಮೂಲಭೂತ ಹಕ್ಕುಗಳಿಲ್ಲ ಎಂದು ಹೇಳಿದ್ದರು” ಎಂದರು.
Today, I am talking to students who would be playing a key role in Indias development in 2047, when we mark a hundred years since independence	“ಇಂದು, ನಾನು 2047 ರಲ್ಲಿ ಸ್ವಾತಂತ್ರ್ಯ ನೂರು ವರ್ಷಗಳನ್ನು ಆಚರಿಸುವ, ಭಾರತದ ಅಭಿವೃದ್ಧಿಯಲ್ಲಿ ಪ್ರಮುಖ ಪಾತ್ರ ವಹಿಸುವ ವಿದ್ಯಾರ್ಥಿಗಳೊಂದಿಗೆ ಮಾತನಾಡುತ್ತಿದ್ದೇನೆ.
I hope this generation takes it upon themselves to act on some of the Fundamental Duties enshrined in our Constitution, he said.	ನಮ್ಮ ಸಂವಿಧಾನದಲ್ಲಿ ಪ್ರತಿಪಾದಿಸಲಾಗಿರುವ ಕೆಲವು ಮೂಲಭೂತ ಕರ್ತವ್ಯಗಳ ಮೇಲೆ ಕಾರ್ಯನಿರ್ವಹಿಸಲು ಈ ಪೀಳಿಗೆಯವರು ತಮ್ಮನ್ನು ತಾವು ಅರ್ಪಿಸಿಕೊಳ್ಳುತ್ತಾರೆ ಎಂದು ನಾನು ಭಾವಿಸುತ್ತೇನೆ ”ಎಂದು ಅವರು ಹೇಳಿದರು.
How to deal with pressure and expectations from parents and teachers?	ಪೋಷಕರು ಮತ್ತು ಶಿಕ್ಷಕರ ಒತ್ತಡ ಮತ್ತು ನಿರೀಕ್ಷೆಗಳನ್ನು ಎದುರಿಸುವುದು ಹೇಗೆ?
On how to deal with the pressure and expectations from parents and teachers, the Prime Minister urged the parents not pressurize the students but to pursue with them.	ಪೋಷಕರು ಮತ್ತು ಶಿಕ್ಷಕರಿಂದ ಬರುವ ಒತ್ತಡ ಮತ್ತು ನಿರೀಕ್ಷೆಗಳನ್ನು ಎದುರಿಸುವುದು ಹೇಗೆ ಎಂಬ ಬಗ್ಗೆ ಮಾತನಾಡಿದ ಪ್ರಧಾನಿಯವರು, ಪೋಷಕರು ವಿದ್ಯಾರ್ಥಿಗಳ ಮೇಲೆ ಒತ್ತಡ ಹೇರದೆ ಅವರಿಗೆ ಬೆಂಬಲವಾಗಿರಬೇಕು ಎಂದು ಆಗ್ರಹಿಸಿದರು.
Inspire children to do things that bring out their inner potential	ಅವರ ಆಂತರಿಕ ಸಾಮರ್ಥ್ಯವನ್ನು ಹೊರತೆಗೆಯುವ ಕೆಲಸಗಳನ್ನು ಮಾಡಲು ಮಕ್ಕಳನ್ನು ಹುರಿದುಂಬಿಸಿ ” ಎಂದರು.
Best time to study and blanking out during the exam and Fear of Board Exams	ಪರೀಕ್ಷೆ ಸಮಯದಲ್ಲಿ ಅಧ್ಯಯನ ಮತ್ತು ವಿಶ್ರಾಂತಿಗೆ ಉತ್ತಮ ಸಮಯ ಮತ್ತು ಬೋರ್ಡ್ ಪರೀಕ್ಷೆಗಳ ಭಯ
On a question on what is the best time to study, the Prime Minister advised that ample rest is as important as the study itself.	ಅಧ್ಯಯನ ಮಾಡಲು ಉತ್ತಮ ಸಮಯ ಯಾವುದು ಎಂಬ ಪ್ರಶ್ನೆಗೆ, ವಿಶ್ರಾಂತಿಯೂ ಅಧ್ಯಯನದಷ್ಟೇ ಮುಖ್ಯ ಎಂದು ಪ್ರಧಾನಿ ಸಲಹೆ ನೀಡಿದರು.
On the issue of sudden blanking out during exams, the Prime Minister asked the students to be thorough in their preparation.	ಪರೀಕ್ಷೆಯ ಸಮಯದಲ್ಲಿ ಹಠಾತ್ತಾಗಿ ಎಲ್ಲವೂ ಖಾಲಿಯಾದ ಸ್ಥಿತಿಯ ಬಗ್ಗೆ ಉತ್ತರಿಸಿದ  ಪ್ರಧಾನಮಂತ್ರಿಯವರು,  ವಿದ್ಯಾರ್ಥಿಗಳು ಸಮಗ್ರವಾಗಿ ತಯಾರಿ ಮಾಡಿಕೊಳ್ಳಬೇಕು ಎಂದರು.
I would urge students to be confident about their own preparation	ವಿದ್ಯಾರ್ಥಿಗಳು ತಮ್ಮದೇ ಆದ ತಯಾರಿಯ ಬಗ್ಗೆ ವಿಶ್ವಾಸ ಹೊಂದಿರಬೇಕು.
Do not enter the exam hall with any sort of pressure	ಯಾವುದೇ ರೀತಿಯ ಒತ್ತಡದಿಂದ ಪರೀಕ್ಷಾ ಹಾಲ್‌ಗೆ ಪ್ರವೇಶಿಸಬೇಡಿ.
Do not worry about what others are doing	ಇತರರು ಏನು ಮಾಡುತ್ತಿದ್ದಾರೆ ಎಂಬ ಬಗ್ಗೆ ಚಿಂತಿಸಬೇಡಿ.